User,Retweet Degree,Reply Degree,Retweet Community,Reply Community,Multi Retweet In Degree,Multi Retweet Out Degree,Multi Retweet Degree,Multi Reply In Degree,Multi Reply Out Degree,Multi Reply Degree
377,1325,833,0,1,8417,6,8423,5571,2,5573
3,1270,773,0,0,11365,502,11867,5010,460,5470
118,1232,535,0,0,4111,693,4804,1221,224,1445
8,1229,842,0,0,6430,750,7180,4022,282,4304
91,1139,655,0,0,5815,476,6291,3140,858,3998
5,1116,780,0,0,6512,266,6778,3497,381,3878
174,1116,830,1,0,9946,671,10617,5245,341,5586
565,1092,300,0,1,7059,833,7892,961,82,1043
861,1072,530,1,0,5842,753,6595,1297,149,1446
114,1050,419,0,0,3963,8,3971,1037,7,1044
77,1044,518,0,1,3813,141,3954,2204,285,2489
415,1037,585,0,0,4241,0,4241,2399,8,2407
51,1034,445,0,0,4026,411,4437,1048,0,1048
35,1032,869,1,0,5908,276,6184,4767,258,5025
1319,1031,522,0,0,4340,275,4615,1342,824,2166
385,1027,613,1,1,7704,32,7736,2126,102,2228
10,1024,659,1,0,5595,1562,7157,3005,95,3100
7,1017,513,1,0,5385,1956,7341,2141,28,2169
0,1014,702,1,0,3882,1236,5118,2437,106,2543
204,999,334,0,0,4976,16,4992,844,45,889
40,994,780,1,2,10279,465,10744,3745,226,3971
14,983,517,1,0,3953,934,4887,1346,395,1741
110,980,340,0,0,5826,1445,7271,879,140,1019
32,974,774,1,0,3553,325,3878,2333,501,2834
163,967,415,1,0,3855,1461,5316,753,80,833
20,966,606,1,0,4563,706,5269,2293,72,2365
128,961,652,0,0,2502,729,3231,1571,270,1841
1056,953,556,1,2,7573,916,8489,2585,824,3409
79,952,553,0,0,2708,372,3080,1777,708,2485
13,950,317,0,0,3957,1173,5130,835,186,1021
58,948,590,1,0,3617,569,4186,1647,430,2077
134,946,493,1,0,3893,893,4786,1171,443,1614
836,925,418,1,0,2608,1435,4043,917,100,1017
107,924,683,1,0,8990,839,9829,4470,432,4902
158,913,705,1,2,5687,1579,7266,3615,241,3856
1185,911,489,1,0,7697,279,7976,912,490,1402
3098,906,516,1,2,2902,1386,4288,1835,268,2103
444,902,291,0,1,2447,17,2464,1067,501,1568
34,899,495,1,2,2579,1599,4178,2193,103,2296
62,898,468,0,1,5105,1344,6449,2025,352,2377
81,889,358,1,0,3815,501,4316,852,231,1083
389,876,768,0,0,2906,361,3267,2890,465,3355
376,870,401,1,0,2720,1114,3834,1012,17,1029
575,869,356,0,0,2570,753,3323,922,507,1429
357,859,240,0,0,5185,735,5920,609,139,748
1,852,557,0,0,2607,174,2781,1984,678,2662
637,852,317,1,2,3179,1347,4526,676,81,757
165,849,349,0,1,3522,1136,4658,942,123,1065
25,841,288,0,0,2649,1207,3856,354,220,574
71,840,550,1,0,2911,1542,4453,1594,399,1993
1684,838,512,1,1,4265,569,4834,1679,497,2176
27,823,311,1,2,3413,1705,5118,719,0,719
31,814,590,1,0,5449,418,5867,2242,922,3164
210,813,519,1,2,4044,499,4543,1726,345,2071
122,807,233,1,0,3633,731,4364,640,317,957
89,802,400,0,0,1799,566,2365,690,172,862
838,802,273,0,0,1406,1271,2677,450,61,511
404,791,458,0,0,1364,896,2260,1136,130,1266
247,790,328,1,1,1943,941,2884,695,28,723
203,789,702,1,0,3008,487,3495,2655,16,2671
54,787,519,1,2,3409,753,4162,1907,119,2026
1082,783,528,0,0,1746,1021,2767,1570,215,1785
238,781,220,1,2,1142,1308,2450,361,84,445
644,775,559,1,2,3251,996,4247,2230,99,2329
53,769,471,1,2,2416,476,2892,1286,476,1762
1145,769,215,1,2,1325,1639,2964,479,22,501
354,768,428,1,2,4853,28,4881,1153,64,1217
416,768,369,1,0,934,1091,2025,676,133,809
78,764,137,0,0,7445,90,7535,349,136,485
317,761,524,0,0,2205,606,2811,2419,260,2679
24,758,113,0,0,5516,1138,6654,666,510,1176
436,758,262,0,1,2740,341,3081,968,431,1399
11,753,536,1,0,1831,290,2121,790,1299,2089
778,753,206,0,0,1267,1621,2888,245,64,309
69,751,501,0,0,1903,221,2124,1575,729,2304
3183,746,225,0,1,1796,2,1798,450,0,450
76,743,419,1,0,1956,537,2493,1156,0,1156
123,743,428,1,2,2826,681,3507,1981,181,2162
1146,742,494,0,0,2610,76,2686,2250,1021,3271
929,741,287,1,0,1280,1386,2666,565,150,715
167,740,223,0,0,2019,756,2775,448,124,572
171,735,351,0,0,2003,10,2013,2124,1348,3472
371,733,751,0,0,2117,393,2510,3106,86,3192
3556,733,403,1,1,3784,0,3784,1017,0,1017
29,731,572,1,2,3819,556,4375,4121,444,4565
1111,730,179,0,0,1589,692,2281,583,621,1204
310,728,450,1,2,2419,505,2924,1037,237,1274
855,722,470,1,2,1390,1265,2655,1713,320,2033
432,718,210,0,1,4028,11,4039,451,344,795
50,716,543,1,2,1722,1185,2907,2514,296,2810
515,715,411,1,2,1679,571,2250,1430,205,1635
1244,713,127,1,2,639,1615,2254,145,30,175
113,710,542,0,0,1313,347,1660,1469,624,2093
30,703,469,1,2,2941,179,3120,1596,400,1996
267,702,355,1,0,1310,811,2121,793,416,1209
126,701,334,0,0,2044,267,2311,601,455,1056
856,699,377,1,1,4002,218,4220,1222,250,1472
1118,699,416,0,1,5102,61,5163,2562,84,2646
270,696,415,1,2,3105,411,3516,925,202,1127
791,694,455,0,0,1968,442,2410,1474,696,2170
2792,694,320,0,0,637,1460,2097,411,475,886
233,693,401,1,0,3201,137,3338,1418,271,1689
280,693,204,1,2,2745,406,3151,469,106,575
356,693,391,1,0,1567,297,1864,922,350,1272
248,690,314,1,0,1726,438,2164,854,527,1381
143,689,258,1,2,1481,1233,2714,611,312,923
441,687,255,1,2,2321,1668,3989,468,89,557
255,686,569,0,2,2965,109,3074,2554,18,2572
57,683,48,1,0,200,1990,2190,80,13,93
295,683,62,1,2,204,1585,1789,58,28,86
1266,680,407,1,0,1651,109,1760,1023,645,1668
577,679,420,0,2,1557,74,1631,1262,13,1275
569,671,129,0,1,2759,544,3303,531,322,853
1153,671,100,1,2,408,1713,2121,147,11,158
28,670,670,1,2,4441,38,4479,1297,988,2285
1012,670,280,1,2,932,931,1863,480,83,563
15,668,333,1,2,3267,0,3267,631,0,631
698,666,417,1,2,1840,511,2351,914,399,1313
2361,665,180,1,0,2430,569,2999,342,91,433
1039,664,139,1,2,341,1952,2293,167,116,283
398,663,597,1,2,4687,1024,5711,4694,234,4928
429,663,276,0,0,4059,681,4740,1255,103,1358
823,663,493,0,2,1890,135,2025,2563,3,2566
36,662,149,0,0,2112,396,2508,804,599,1403
164,662,306,0,0,1414,396,1810,536,280,816
242,662,329,1,0,1210,1158,2368,631,123,754
446,661,289,0,0,1223,847,2070,438,309,747
1465,657,535,1,0,2390,0,2390,1512,0,1512
75,656,435,0,0,1228,470,1698,989,297,1286
455,655,253,1,2,761,1664,2425,611,0,611
428,654,343,1,2,1652,947,2599,864,12,876
135,653,436,1,0,1350,429,1779,962,749,1711
391,653,475,1,2,1831,885,2716,715,549,1264
437,653,481,0,0,1572,347,1919,1045,268,1313
933,653,314,0,0,2264,92,2356,1746,1121,2867
2660,653,97,0,0,1684,1251,2935,359,208,567
1068,652,352,0,0,1885,485,2370,829,504,1333
332,651,382,1,2,988,1280,2268,262,632,894
497,651,262,1,0,468,1214,1682,396,193,589
115,648,301,1,0,1163,1113,2276,416,562,978
640,648,346,1,2,692,1166,1858,245,478,723
1495,648,197,0,1,1744,0,1744,537,85,622
809,644,235,1,0,2439,314,2753,1178,856,2034
1294,644,274,1,2,3215,0,3215,514,0,514
312,643,252,0,0,3026,421,3447,895,829,1724
1513,643,142,1,2,435,1445,1880,160,61,221
152,641,249,1,0,810,928,1738,244,415,659
464,640,229,1,0,2030,51,2081,372,112,484
798,640,404,0,0,1999,296,2295,1409,657,2066
106,639,347,1,2,911,851,1762,620,229,849
858,638,230,1,0,1797,1754,3551,508,337,845
499,635,227,1,2,914,1273,2187,263,250,513
172,634,279,0,0,1078,1334,2412,296,420,716
235,634,247,0,0,949,805,1754,254,311,565
1456,633,256,1,2,2945,759,3704,489,133,622
1809,633,708,0,0,1698,663,2361,2754,194,2948
157,632,488,1,2,1794,680,2474,884,441,1325
3215,631,221,1,2,776,1177,1953,344,121,465
1333,629,238,0,1,1348,2,1350,668,27,695
2321,627,492,1,2,1862,524,2386,963,589,1552
95,626,171,1,0,1267,1026,2293,287,64,351
365,626,244,0,0,1374,1311,2685,329,220,549
911,625,114,1,0,1811,42,1853,218,99,317
154,624,194,1,2,599,1399,1998,157,194,351
1698,624,166,1,0,1166,1750,2916,245,86,331
722,623,417,1,2,1596,822,2418,1129,292,1421
818,619,343,1,2,642,1265,1907,228,533,761
183,618,240,1,0,870,598,1468,676,74,750
1231,618,223,1,0,1954,164,2118,685,335,1020
676,613,224,1,2,1257,872,2129,359,136,495
1404,613,83,1,2,278,1501,1779,121,0,121
1964,613,365,1,2,534,1132,1666,667,305,972
149,611,314,1,2,2251,823,3074,1034,15,1049
1132,609,347,1,2,697,1390,2087,368,416,784
418,608,341,1,2,891,1107,1998,536,460,996
781,608,266,1,0,496,1263,1759,365,377,742
309,606,346,1,0,813,830,1643,914,320,1234
496,602,400,1,2,1135,1010,2145,445,852,1297
220,601,102,0,0,1448,67,1515,132,6,138
303,601,329,1,2,2503,589,3092,607,337,944
785,601,96,1,2,207,1701,1908,64,74,138
67,600,235,1,0,864,1384,2248,189,269,458
257,600,356,1,0,4284,364,4648,2152,1016,3168
197,599,308,1,2,4976,106,5082,1323,516,1839
1638,599,382,1,2,1479,1036,2515,489,475,964
1370,598,116,0,1,1419,0,1419,188,0,188
3202,598,385,0,0,1808,394,2202,1343,596,1939
315,597,162,1,2,2401,557,2958,343,116,459
387,597,781,2,1,5977,0,5977,6716,0,6716
811,596,928,2,1,11703,341,12044,14153,80,14233
1801,596,355,1,2,442,804,1246,339,554,893
12,595,147,0,0,1468,830,2298,527,353,880
18,592,368,0,0,1144,1009,2153,912,266,1178
162,590,524,1,0,1534,82,1616,957,580,1537
291,590,322,1,2,1826,552,2378,1121,166,1287
980,589,316,1,2,1748,670,2418,1043,0,1043
88,588,260,0,0,2609,891,3500,321,256,577
510,588,425,1,2,902,897,1799,627,398,1025
254,587,91,0,1,2320,25,2345,190,22,212
1148,587,366,1,2,977,411,1388,309,676,985
3394,587,144,1,0,56,1352,1408,44,206,250
277,585,48,1,2,57,1633,1690,25,57,82
1963,585,87,0,0,486,1793,2279,184,75,259
121,582,204,0,0,2074,1494,3568,495,477,972
1812,582,226,1,2,217,1654,1871,161,244,405
21,580,297,1,2,2059,690,2749,1080,717,1797
276,580,358,1,2,1281,1272,2553,365,590,955
3249,580,200,1,2,112,1269,1381,120,232,352
202,577,260,0,0,1083,1195,2278,409,80,489
324,577,350,0,0,1737,67,1804,977,720,1697
217,576,270,1,2,524,1258,1782,242,223,465
290,576,278,1,0,418,1296,1714,531,412,943
221,575,150,0,1,2211,377,2588,606,277,883
802,575,271,1,2,839,832,1671,369,146,515
1157,575,137,1,0,81,1731,1812,78,153,231
2128,574,114,1,2,154,1373,1527,88,127,215
2618,574,190,0,1,2576,1,2577,394,30,424
131,572,238,0,0,839,784,1623,909,554,1463
305,572,309,0,0,1131,442,1573,1164,632,1796
307,572,133,1,2,657,1291,1948,318,32,350
494,572,149,1,2,792,1393,2185,234,73,307
1831,570,86,0,0,1426,314,1740,130,8,138
120,569,138,0,0,3105,1864,4969,323,128,451
209,569,323,1,0,1062,362,1424,312,548,860
344,569,480,0,0,1179,345,1524,1079,185,1264
1475,569,72,0,0,1520,328,1848,190,91,281
671,568,100,1,0,155,1263,1418,86,66,152
1264,568,171,0,0,1493,604,2097,289,167,456
996,567,202,1,2,402,1254,1656,168,170,338
3643,567,289,1,2,485,1584,2069,538,230,768
521,565,254,1,2,461,1353,1814,275,217,492
47,564,359,1,2,1746,308,2054,711,487,1198
1302,564,175,1,0,412,1066,1478,229,160,389
1210,563,225,1,2,290,1704,1994,164,323,487
1442,563,185,1,0,507,816,1323,308,32,340
3726,562,114,1,0,24,1543,1567,71,115,186
1315,561,105,0,1,1211,14,1225,301,103,404
104,560,208,0,0,1113,188,1301,451,10,461
141,559,245,0,1,2233,212,2445,1681,944,2625
333,558,78,0,0,1813,1802,3615,174,104,278
1337,558,264,0,0,1322,415,1737,633,142,775
144,557,275,0,0,949,1079,2028,278,403,681
1844,557,63,1,2,49,1963,2012,59,75,134
3656,557,246,1,0,449,1619,2068,310,259,569
852,556,357,1,0,501,1081,1582,611,253,864
1741,556,155,0,0,1754,181,1935,384,301,685
2716,556,96,1,2,3,1990,1993,9,122,131
263,555,265,0,0,1433,775,2208,1276,959,2235
3315,555,272,1,2,427,1327,1754,142,436,578
467,554,257,1,0,818,1358,2176,339,258,597
821,552,416,0,0,1312,187,1499,1676,723,2399
288,551,264,0,0,1395,715,2110,1105,1029,2134
367,551,394,1,2,2311,67,2378,1701,441,2142
513,551,301,0,0,1465,48,1513,713,41,754
3156,551,181,1,2,501,1113,1614,135,187,322
3481,551,303,0,0,945,558,1503,750,337,1087
96,550,146,0,0,1052,1039,2091,271,175,446
199,550,564,1,2,1315,340,1655,871,1328,2199
1182,550,85,0,0,123,1420,1543,66,133,199
831,549,110,0,0,500,1477,1977,178,194,372
1686,549,213,1,0,597,1081,1678,396,289,685
39,548,148,1,2,388,1652,2040,319,2,321
630,548,192,1,2,210,1988,2198,210,132,342
769,547,224,1,2,288,943,1231,187,263,450
786,547,344,1,2,1378,1001,2379,878,291,1169
1762,547,402,0,0,888,275,1163,846,326,1172
347,546,234,1,2,495,1175,1670,768,151,919
1896,546,315,1,2,548,999,1547,293,535,828
82,545,169,1,0,1744,0,1744,356,0,356
90,545,229,0,0,2265,808,3073,766,661,1427
2726,545,204,1,0,1610,898,2508,301,222,523
327,542,452,0,0,1242,18,1260,1356,18,1374
2387,541,139,1,2,179,1833,2012,121,100,221
109,538,287,1,2,1316,1409,2725,547,440,987
1121,538,126,1,2,358,1304,1662,187,18,205
360,537,70,1,2,35,1178,1213,31,67,98
3653,537,92,1,0,71,1546,1617,38,127,165
871,536,251,1,0,1391,294,1685,287,468,755
1048,535,196,1,0,942,270,1212,212,209,421
1083,535,58,1,2,11,1794,1805,64,79,143
1382,535,221,0,0,1635,515,2150,1299,758,2057
3517,535,144,1,2,34,1416,1450,35,167,202
601,533,17,0,0,137,1977,2114,56,44,100
142,532,305,1,2,1512,289,1801,607,26,633
3258,532,209,1,0,775,1222,1997,432,0,432
3459,532,319,1,2,488,1049,1537,203,523,726
3693,532,87,1,2,27,1779,1806,19,87,106
1165,531,279,1,1,783,516,1299,478,283,761
3812,531,198,1,0,180,1472,1652,344,291,635
2280,530,147,1,0,202,1391,1593,177,191,368
2979,530,188,0,0,1436,519,1955,427,473,900
3078,530,224,1,2,125,1454,1579,73,391,464
298,528,182,0,0,938,1372,2310,264,282,546
724,528,178,1,2,100,1632,1732,57,231,288
1371,527,220,1,0,1152,966,2118,559,363,922
3509,527,313,0,0,789,704,1493,471,315,786
3658,527,365,1,2,570,1079,1649,296,494,790
56,526,228,1,0,205,1586,1791,229,226,455
723,526,195,0,0,1215,624,1839,559,632,1191
1652,526,280,0,0,1090,287,1377,896,740,1636
151,524,150,0,0,1739,1389,3128,258,180,438
520,524,153,0,0,1509,1409,2918,282,275,557
649,524,295,1,2,687,758,1445,384,273,657
3299,523,165,1,2,143,1420,1563,122,161,283
822,522,185,1,2,299,1808,2107,97,290,387
1550,522,412,1,2,2030,437,2467,2147,349,2496
2734,522,315,1,0,331,1396,1727,122,674,796
3502,522,217,1,2,259,902,1161,94,278,372
711,521,307,0,1,2012,150,2162,1913,1138,3051
1689,520,173,1,0,1790,1499,3289,192,111,303
1887,520,58,1,2,74,1467,1541,56,17,73
2925,520,44,1,2,34,1840,1874,22,37,59
3171,520,121,1,0,271,1031,1302,172,27,199
3200,520,319,1,2,435,1009,1444,190,551,741
2392,519,219,0,0,310,873,1183,459,400,859
2774,517,389,1,0,1122,440,1562,783,630,1413
3499,516,466,1,2,1229,664,1893,786,836,1622
361,515,121,0,0,898,991,1889,203,211,414
3460,515,290,1,0,287,1335,1622,211,518,729
918,513,282,0,0,1822,429,2251,744,861,1605
1161,513,51,1,2,182,1258,1440,50,22,72
1329,513,28,1,2,67,2258,2325,20,12,32
1589,513,282,1,0,712,701,1413,262,524,786
915,512,322,1,2,595,877,1472,354,394,748
1630,512,394,1,2,1251,888,2139,443,703,1146
892,511,117,1,2,261,768,1029,174,45,219
1074,511,86,1,2,440,1844,2284,89,68,157
1168,511,126,1,0,152,1380,1532,127,179,306
373,510,74,1,2,300,1345,1645,147,53,200
2233,510,152,0,0,69,1773,1842,153,200,353
1565,509,305,1,2,486,1034,1520,335,429,764
2625,509,3,1,0,10,1414,1424,3,0,3
3381,508,170,0,0,2611,216,2827,953,567,1520
1034,507,105,0,0,426,1324,1750,136,155,291
1441,507,338,1,0,510,659,1169,460,850,1310
775,506,263,1,2,236,1176,1412,157,351,508
1021,506,118,0,0,33,1610,1643,19,221,240
2976,506,296,1,0,2181,100,2281,836,387,1223
3146,506,144,1,0,444,1201,1645,199,384,583
2898,505,48,1,2,181,1843,2024,58,42,100
159,504,199,1,2,773,1025,1798,353,94,447
492,504,187,0,0,133,1548,1681,105,311,416
502,504,253,0,0,841,1055,1896,563,228,791
1028,504,125,1,2,1192,9,1201,175,10,185
1284,504,319,0,0,1350,9,1359,560,421,981
3095,503,114,1,0,633,539,1172,121,110,231
991,502,372,0,0,1360,151,1511,854,444,1298
2328,502,42,0,0,149,1663,1812,39,45,84
232,501,123,0,1,2242,112,2354,381,163,544
264,501,146,1,0,2051,101,2152,436,260,696
3729,501,277,1,2,324,1479,1803,170,596,766
265,500,70,0,1,2296,4,2300,121,9,130
419,500,31,0,0,160,1040,1200,29,6,35
1107,500,266,1,2,110,1624,1734,121,495,616
2509,499,46,1,2,8,1324,1332,17,45,62
3662,499,53,1,2,292,1215,1507,89,1,90
320,497,146,0,0,2570,673,3243,1203,1165,2368
1024,497,221,1,2,108,1407,1515,137,433,570
1332,495,230,1,2,511,1047,1558,283,448,731
1398,495,226,1,2,16,1673,1689,22,357,379
965,494,256,1,2,1237,926,2163,684,116,800
1472,494,237,1,0,243,1394,1637,149,494,643
4035,494,164,1,2,332,872,1204,203,38,241
516,493,190,0,1,1007,2,1009,407,34,441
731,493,248,1,2,611,866,1477,370,190,560
2009,493,290,1,2,332,1007,1339,361,495,856
3727,492,183,1,2,92,1518,1610,26,244,270
1788,491,26,0,0,87,1604,1691,69,71,140
423,490,81,0,0,2667,1508,4175,243,162,405
1317,490,208,1,0,111,1618,1729,85,403,488
3007,490,160,0,0,10,1961,1971,8,267,275
223,488,86,1,0,325,1701,2026,103,72,175
1282,488,265,1,2,275,974,1249,187,532,719
815,487,134,0,0,427,681,1108,169,166,335
1828,487,407,1,2,556,587,1143,695,775,1470
2515,487,114,0,1,2057,429,2486,933,813,1746
473,486,288,1,0,333,723,1056,195,389,584
1385,486,220,0,0,655,553,1208,353,48,401
550,485,148,0,1,1671,87,1758,1010,754,1764
755,484,323,0,0,1753,338,2091,1571,867,2438
1129,484,7,1,2,4,2026,2030,5,6,11
969,483,93,1,2,50,1759,1809,57,121,178
1355,483,336,1,2,245,1022,1267,290,697,987
1459,483,86,0,0,496,1282,1778,81,105,186
1731,482,225,0,0,547,603,1150,262,429,691
190,480,254,1,2,1539,611,2150,1229,205,1434
239,480,242,1,2,211,966,1177,87,365,452
1032,480,266,1,2,1046,1077,2123,510,312,822
2933,480,216,1,0,52,1313,1365,186,247,433
3648,480,7,1,0,9,1881,1890,3,8,11
178,479,313,1,2,606,1032,1638,245,703,948
1071,479,223,1,2,284,703,987,158,270,428
1072,479,239,1,2,951,279,1230,654,283,937
1526,479,161,1,2,52,1252,1304,28,227,255
2803,479,90,0,0,6,1487,1493,19,128,147
3958,479,111,1,2,78,1663,1741,71,180,251
256,478,373,1,2,413,597,1010,262,798,1060
452,478,128,0,0,1481,1223,2704,342,303,645
1300,478,246,1,2,371,846,1217,222,259,481
1419,477,78,1,2,231,1302,1533,97,18,115
2624,477,232,0,0,825,900,1725,528,381,909
3590,477,116,1,2,416,1470,1886,278,18,296
63,476,102,0,0,1620,452,2072,186,134,320
527,476,314,0,0,593,1127,1720,304,758,1062
1683,476,78,0,0,2121,56,2177,215,75,290
2142,476,114,1,2,98,1322,1420,42,181,223
2153,476,32,1,2,101,1965,2066,3,49,52
155,475,176,0,0,1386,193,1579,428,380,808
325,475,104,1,2,669,1540,2209,122,114,236
937,475,81,1,2,97,992,1089,78,43,121
2921,475,114,1,0,84,1212,1296,37,170,207
3738,475,175,0,0,147,1264,1411,186,332,518
3951,475,28,1,2,65,1444,1509,34,0,34
893,474,92,0,0,453,645,1098,132,140,272
953,474,308,1,0,292,1109,1401,203,621,824
2183,474,247,1,2,921,237,1158,522,329,851
2694,474,242,1,0,108,813,921,299,183,482
3469,474,87,1,2,483,1068,1551,55,130,185
236,473,366,1,2,1077,855,1932,868,126,994
3205,473,202,1,2,164,1037,1201,224,276,500
6,471,192,0,0,839,433,1272,468,241,709
843,471,291,1,2,346,931,1277,280,435,715
2557,471,89,1,2,486,1294,1780,224,51,275
252,469,249,1,0,1335,330,1665,745,861,1606
3486,469,103,1,2,61,2182,2243,53,153,206
66,468,126,0,0,163,1443,1606,164,395,559
1536,467,153,1,0,489,917,1406,327,231,558
3025,467,275,1,2,23,1262,1285,26,474,500
117,466,357,1,2,1328,123,1451,1091,440,1531
3212,466,15,1,2,37,1768,1805,17,17,34
1291,465,157,0,0,359,587,946,415,67,482
1299,465,250,1,2,1565,104,1669,536,121,657
1471,465,282,1,0,117,1154,1271,190,526,716
1569,465,219,1,2,247,1539,1786,113,411,524
3575,465,57,0,0,17,1833,1850,36,143,179
193,464,157,1,2,226,1413,1639,116,161,277
227,464,253,1,2,24,1189,1213,29,522,551
1423,464,41,0,0,1164,1358,2522,114,43,157
3312,464,88,1,1,71,1765,1836,37,135,172
212,463,341,1,0,1108,227,1335,546,220,766
450,463,268,1,0,296,957,1253,165,621,786
1290,463,284,1,0,635,357,992,656,445,1101
1754,463,155,1,2,609,865,1474,358,70,428
3337,463,268,1,0,143,1144,1287,186,399,585
3978,463,224,1,2,68,1123,1191,96,395,491
136,462,373,1,2,994,256,1250,837,715,1552
1079,462,101,0,0,297,1396,1693,68,185,253
621,461,105,0,0,1027,957,1984,271,132,403
751,460,287,1,2,278,2034,2312,202,424,626
912,460,300,1,2,1235,278,1513,925,426,1351
1026,460,340,1,0,722,300,1022,653,626,1279
829,459,215,0,0,957,378,1335,828,480,1308
3591,459,313,1,2,1555,264,1819,641,270,911
2020,458,230,1,2,116,1261,1377,153,484,637
842,457,30,0,0,74,1535,1609,85,50,135
225,456,272,1,0,1774,288,2062,645,235,880
695,456,261,0,0,935,169,1104,636,737,1373
988,456,123,0,0,97,1828,1925,39,181,220
2249,456,450,1,2,234,744,978,192,810,1002
1364,455,185,1,0,427,1488,1915,220,257,477
3117,455,69,1,2,309,1881,2190,104,8,112
3470,455,249,0,0,17,1502,1519,45,555,600
1399,454,188,0,0,772,332,1104,325,93,418
2652,454,166,1,2,55,1822,1877,23,364,387
1521,453,216,0,0,1099,281,1380,504,530,1034
1816,453,195,1,0,53,915,968,115,365,480
2634,453,308,1,2,2320,0,2320,1016,0,1016
665,452,115,0,0,1320,873,2193,143,221,364
2554,452,225,1,2,40,1207,1247,61,471,532
694,451,284,1,0,274,775,1049,391,680,1071
1400,451,310,1,0,1382,442,1824,1288,886,2174
3758,451,332,1,2,551,547,1098,147,743,890
272,450,185,1,0,449,875,1324,278,140,418
646,450,378,1,2,678,402,1080,731,463,1194
2558,450,91,1,2,192,947,1139,140,21,161
545,449,67,0,0,1315,1446,2761,135,103,238
613,449,223,1,2,254,592,846,217,330,547
993,449,191,1,2,412,651,1063,198,199,397
463,447,125,0,1,1054,86,1140,258,68,326
1682,447,293,1,2,315,671,986,262,579,841
2501,446,173,1,0,29,1648,1677,79,421,500
268,445,58,0,0,305,1313,1618,33,53,86
505,445,236,1,0,824,1004,1828,569,446,1015
679,445,343,1,2,859,639,1498,899,138,1037
1080,445,306,1,2,355,1031,1386,165,675,840
1096,445,313,0,0,140,751,891,148,592,740
1906,445,216,0,0,1361,514,1875,695,380,1075
3636,445,128,1,2,37,1530,1567,24,198,222
269,444,81,1,2,23,1453,1476,22,94,116
388,444,176,0,0,405,488,893,488,440,928
484,444,88,1,2,1386,1482,2868,140,2,142
1877,443,103,1,0,475,1031,1506,138,64,202
2695,443,218,1,2,192,1056,1248,211,430,641
1301,442,172,0,0,378,829,1207,299,235,534
3147,442,104,1,2,84,1394,1478,27,124,151
3666,441,205,1,2,245,1006,1251,61,329,390
258,440,171,1,2,340,1231,1571,155,105,260
1217,440,176,1,1,911,169,1080,439,181,620
1583,440,83,0,0,2695,840,3535,121,19,140
3880,440,77,1,2,62,1063,1125,22,96,118
336,439,61,0,0,2096,528,2624,260,227,487
1427,439,127,1,1,144,904,1048,37,442,479
3351,439,242,0,0,800,648,1448,431,591,1022
406,438,259,1,2,1724,496,2220,966,40,1006
468,438,222,0,0,503,678,1181,416,263,679
3543,438,216,1,0,3,1686,1689,11,633,644
3630,437,475,1,2,1337,47,1384,274,1020,1294
175,436,228,1,2,706,919,1625,310,370,680
461,436,163,1,0,1263,671,1934,321,318,639
870,436,229,1,2,346,777,1123,282,302,584
3483,436,194,1,2,244,825,1069,134,546,680
181,435,198,1,2,501,1928,2429,352,179,531
794,435,90,0,0,904,671,1575,180,143,323
1016,435,74,1,2,67,1427,1494,59,64,123
153,434,261,1,2,1433,0,1433,491,0,491
2924,434,187,1,0,1603,150,1753,1220,712,1932
160,433,393,1,0,468,454,922,172,1349,1521
2342,433,166,1,0,283,798,1081,115,176,291
1817,432,353,1,0,54,968,1022,65,817,882
1955,432,398,1,2,530,641,1171,570,754,1324
3514,432,157,1,0,189,1133,1322,258,343,601
1038,431,172,1,2,307,1631,1938,157,162,319
2295,431,149,1,2,83,1681,1764,51,268,319
2709,431,286,0,0,224,968,1192,192,617,809
17,430,192,0,0,611,369,980,269,331,600
368,430,189,1,2,31,1512,1543,25,464,489
1671,430,100,0,0,2151,1302,3453,123,9,132
2306,430,315,1,2,587,573,1160,404,718,1122
3187,430,219,0,0,820,94,914,505,667,1172
3650,430,341,1,2,181,898,1079,256,821,1077
701,429,83,0,1,1266,1028,2294,344,202,546
1640,429,139,0,0,65,1265,1330,31,224,255
366,428,167,0,1,1499,269,1768,772,377,1149
1672,428,208,0,0,1848,28,1876,422,0,422
3687,428,36,0,0,100,2317,2417,14,38,52
1585,427,137,1,2,208,908,1116,105,268,373
750,426,356,1,0,61,932,993,129,1255,1384
1086,426,355,1,2,1257,744,2001,969,964,1933
3239,426,170,1,2,75,961,1036,35,296,331
3478,426,191,1,2,266,1145,1411,213,217,430
489,425,183,1,2,472,1233,1705,220,357,577
641,425,279,1,2,512,490,1002,403,695,1098
1063,425,223,1,0,109,916,1025,199,367,566
3045,425,280,1,2,146,770,916,239,625,864
1030,424,101,1,2,44,1034,1078,62,148,210
1127,424,440,1,2,490,521,1011,283,1068,1351
1214,424,87,0,0,815,814,1629,93,26,119
301,423,127,1,2,509,686,1195,119,88,207
1131,423,166,1,2,336,689,1025,240,152,392
3646,422,208,1,2,161,1449,1610,62,361,423
266,421,102,0,0,856,734,1590,776,795,1571
670,421,385,1,2,816,413,1229,558,1016,1574
735,421,210,1,0,412,961,1373,590,439,1029
795,421,90,0,0,2,1649,1651,4,160,164
824,421,172,1,2,465,738,1203,372,228,600
1126,421,258,1,1,21,849,870,22,507,529
1281,421,277,0,0,384,613,997,482,444,926
1721,421,161,1,2,118,1778,1896,76,231,307
2010,421,93,0,0,294,800,1094,281,77,358
2047,421,195,1,2,114,1629,1743,120,354,474
445,420,185,0,0,524,495,1019,271,308,579
1242,420,171,0,0,17,1310,1327,34,412,446
1324,420,111,1,2,374,1830,2204,139,90,229
1582,420,83,1,2,166,838,1004,56,80,136
2572,420,58,0,0,1066,1129,2195,355,290,645
55,419,520,1,2,1333,255,1588,2695,503,3198
93,419,271,0,0,1107,170,1277,1542,671,2213
127,419,158,1,2,572,690,1262,286,91,377
355,419,474,1,2,1156,170,1326,687,985,1672
580,419,433,1,0,681,878,1559,1144,378,1522
1119,419,357,1,2,937,234,1171,739,690,1429
3468,419,256,1,2,327,801,1128,82,755,837
339,418,100,0,0,1118,821,1939,262,171,433
938,418,182,0,2,50,1231,1281,80,395,475
1000,417,265,1,0,194,685,879,300,428,728
2417,417,86,1,2,205,893,1098,36,124,160
168,416,217,1,0,973,226,1199,774,760,1534
282,416,270,1,0,765,0,765,554,264,818
1417,416,182,1,2,49,1187,1236,25,260,285
1899,416,118,1,0,173,929,1102,126,246,372
609,415,110,1,2,143,1540,1683,47,246,293
1979,415,146,0,1,12,1202,1214,95,362,457
3442,415,187,0,0,62,1199,1261,322,581,903
9,414,183,0,0,1038,243,1281,591,468,1059
49,414,179,1,2,1073,699,1772,305,312,617
405,414,485,2,1,2650,360,3010,1583,11,1594
728,414,48,1,2,1,2227,2228,14,54,68
1596,414,172,0,0,900,468,1368,838,710,1548
2389,414,48,0,0,117,1829,1946,47,92,139
3676,414,72,1,2,23,1462,1485,7,98,105
287,413,199,1,0,320,871,1191,491,442,933
1515,413,77,0,0,2202,498,2700,466,402,868
1696,413,144,0,0,744,218,962,329,107,436
2241,413,352,1,0,226,759,985,334,847,1181
207,411,253,1,2,61,1524,1585,60,620,680
1379,411,450,0,2,955,1379,2334,1144,12,1156
1949,411,89,0,0,832,1468,2300,133,185,318
108,410,190,0,0,187,1561,1748,61,453,514
848,410,30,0,0,48,1933,1981,19,31,50
1147,410,264,0,0,613,613,1226,579,167,746
1296,410,140,0,0,14,1394,1408,43,359,402
369,409,174,0,0,705,801,1506,355,321,676
1708,409,61,0,0,42,848,890,74,73,147
1787,409,139,0,0,257,1126,1383,197,374,571
2315,409,51,1,0,269,1603,1872,64,37,101
465,408,238,0,0,437,554,991,490,626,1116
2162,408,123,0,0,1300,1219,2519,180,286,466
213,407,351,1,2,942,694,1636,921,712,1633
1378,407,115,1,2,261,1214,1475,109,119,228
1651,407,248,1,1,644,426,1070,351,25,376
318,406,44,0,0,2320,1608,3928,71,23,94
687,405,481,1,0,560,308,868,1535,710,2245
922,405,28,1,2,163,1253,1416,31,1,32
1540,405,95,0,1,1039,0,1039,234,23,257
820,404,226,0,0,322,952,1274,281,196,477
1286,404,79,0,0,404,695,1099,114,158,272
1567,404,185,1,0,171,830,1001,136,305,441
3520,404,366,1,2,22,675,697,90,779,869
335,403,62,0,0,1775,500,2275,284,231,515
2307,403,244,1,2,19,1116,1135,77,788,865
297,402,156,1,1,70,737,807,115,293,408
393,402,200,1,0,347,642,989,179,268,447
1629,402,202,1,2,387,899,1286,200,559,759
1870,402,184,0,0,1323,399,1722,782,369,1151
2127,402,87,0,0,14,1261,1275,12,155,167
2682,402,120,0,0,16,969,985,536,729,1265
555,401,305,0,1,188,707,895,547,966,1513
810,401,96,1,2,1559,1224,2783,170,50,220
3465,401,314,1,2,34,1073,1107,29,549,578
37,400,155,0,0,1234,548,1782,252,127,379
196,400,217,1,2,457,394,851,249,171,420
737,399,88,0,0,1705,721,2426,201,77,278
739,399,9,1,2,51,1405,1456,9,0,9
1547,399,169,0,2,63,916,979,28,326,354
1680,399,119,0,0,10,1050,1060,173,369,542
132,398,73,0,0,1311,733,2044,294,254,548
1174,398,119,0,0,1276,690,1966,251,188,439
2287,398,284,1,0,18,768,786,132,644,776
3935,398,57,1,2,99,716,815,75,108,183
3579,397,187,0,0,58,1067,1125,28,471,499
3962,397,271,1,2,465,976,1441,140,707,847
793,396,185,1,2,467,428,895,874,714,1588
1700,396,27,1,0,268,1461,1729,21,22,43
2288,396,168,1,0,21,1875,1896,31,393,424
2373,396,61,0,1,269,1773,2042,64,154,218
487,395,72,0,0,719,1449,2168,153,183,336
524,395,59,0,0,160,1357,1517,15,67,82
548,395,130,0,1,1238,319,1557,527,579,1106
865,395,228,1,2,36,1019,1055,79,468,547
1018,395,154,1,2,84,1501,1585,103,273,376
1769,395,53,0,0,9,1125,1134,21,169,190
1811,395,264,1,0,39,874,913,181,528,709
2094,395,264,1,2,5,1460,1465,4,751,755
2308,395,155,1,2,284,705,989,145,137,282
2350,395,15,0,0,10,1891,1901,8,49,57
1415,394,86,0,1,1239,153,1392,916,806,1722
1859,394,47,0,0,26,1013,1039,56,127,183
939,393,125,0,0,922,1170,2092,269,372,641
1015,393,89,0,0,2598,1173,3771,327,157,484
1900,393,178,1,0,147,695,842,121,342,463
3409,393,116,0,0,19,1190,1209,85,369,454
574,392,181,0,1,1545,251,1796,836,611,1447
661,392,337,1,2,153,786,939,129,536,665
1407,392,104,0,1,1312,205,1517,412,241,653
3471,392,239,1,2,35,783,818,108,550,658
744,391,81,0,0,431,709,1140,887,906,1793
1593,391,137,0,0,830,1633,2463,246,280,526
1170,390,357,0,0,521,658,1179,707,310,1017
2810,390,102,0,0,294,2045,2339,123,290,413
3123,390,272,1,1,118,858,976,57,791,848
3277,390,60,0,0,20,1692,1712,26,132,158
562,389,204,1,2,108,1178,1286,59,408,467
1468,389,237,1,0,203,773,976,298,477,775
1880,389,118,0,0,1711,721,2432,143,236,379
2237,389,304,1,0,51,867,918,95,582,677
3024,389,65,1,0,474,753,1227,159,49,208
3541,389,245,1,2,63,888,951,39,434,473
206,388,236,1,0,103,767,870,71,537,608
879,388,297,1,2,419,745,1164,476,478,954
950,388,88,1,0,611,226,837,120,36,156
1387,387,265,1,0,313,760,1073,339,687,1026
1654,386,38,0,0,15,1602,1617,4,76,80
1677,386,108,1,0,82,2269,2351,80,137,217
2090,386,283,1,2,157,827,984,62,646,708
3288,386,25,1,2,5,1369,1374,7,27,34
3963,386,334,0,0,16,1143,1159,42,882,924
101,385,300,1,2,613,131,744,307,525,832
219,385,100,1,2,194,1077,1271,206,19,225
623,385,469,2,1,1085,193,1278,1490,16,1506
1436,385,184,1,0,67,1142,1209,115,442,557
2247,385,43,0,1,1150,0,1150,57,0,57
46,384,231,0,0,481,158,639,499,486,985
2719,384,119,1,0,96,1181,1277,109,243,352
3659,384,42,1,2,1490,1095,2585,219,9,228
460,383,85,0,1,797,44,841,519,464,983
819,383,186,1,2,439,1394,1833,213,251,464
3689,383,119,1,0,32,1737,1769,40,205,245
1500,382,84,0,2,42,1406,1448,58,88,146
3161,382,171,0,0,400,749,1149,186,363,549
3696,382,332,1,2,179,750,929,169,690,859
173,381,168,1,2,1305,0,1305,493,0,493
413,381,21,0,0,21,1498,1519,79,104,183
1167,381,9,0,0,77,2188,2265,38,31,69
1406,381,82,1,0,575,776,1351,127,112,239
87,380,377,0,0,921,139,1060,633,405,1038
386,379,314,1,2,144,811,955,119,817,936
1308,379,240,0,0,1116,94,1210,884,538,1422
1372,379,230,1,2,1574,291,1865,619,147,766
1109,378,232,0,0,844,226,1070,420,87,507
1890,378,135,0,0,368,1109,1477,303,390,693
378,376,112,0,0,1434,632,2066,225,46,271
512,376,98,1,2,762,1551,2313,106,57,163
999,376,104,1,2,84,1424,1508,49,179,228
421,375,397,1,2,776,112,888,525,626,1151
471,375,46,0,1,2019,1242,3261,62,2,64
2909,375,225,1,2,1120,484,1604,514,94,608
3733,375,151,1,0,6,1012,1018,113,542,655
68,374,76,0,1,820,574,1394,177,86,263
984,374,15,0,0,8,1552,1560,4,21,25
3282,374,200,1,2,476,548,1024,313,210,523
3743,373,97,0,1,1095,571,1666,185,34,219
201,372,247,1,2,92,1266,1358,68,627,695
916,372,254,1,2,92,650,742,310,408,718
1350,372,233,0,0,56,609,665,124,440,564
2576,372,160,1,0,7,1271,1278,20,308,328
3708,372,196,1,2,89,704,793,41,315,356
1049,371,163,1,2,96,1412,1508,76,393,469
1124,371,396,1,2,967,10,977,768,614,1382
1144,371,201,1,0,1004,352,1356,580,77,657
359,370,478,1,2,211,455,666,1295,191,1486
835,370,32,0,0,1487,1109,2596,298,269,567
1061,370,192,1,2,263,905,1168,174,472,646
1245,370,135,1,0,93,1391,1484,106,296,402
2100,370,241,1,2,249,910,1159,281,673,954
3219,370,200,0,0,449,463,912,556,361,917
103,369,113,1,0,512,162,674,338,158,496
746,369,207,0,0,536,559,1095,633,615,1248
828,369,120,1,0,416,658,1074,274,73,347
1693,369,319,1,2,238,454,692,208,909,1117
1737,369,46,0,0,183,1916,2099,34,61,95
319,368,36,0,1,1704,1893,3597,63,26,89
634,368,244,1,2,583,999,1582,435,430,865
1254,368,132,1,0,196,1590,1786,162,298,460
382,367,271,1,2,208,601,809,170,616,786
919,367,81,0,0,131,1004,1135,75,85,160
363,366,132,0,0,428,1732,2160,100,161,261
2058,366,227,0,1,1103,204,1307,558,17,575
3479,366,122,1,0,5,1394,1399,16,328,344
427,365,213,0,0,537,411,948,469,711,1180
431,365,223,1,2,74,823,897,98,538,636
2649,365,75,0,0,337,1150,1487,85,134,219
2934,365,210,0,0,31,754,785,128,413,541
2950,365,286,1,2,42,1165,1207,97,767,864
3221,365,61,0,0,294,1312,1606,118,126,244
3487,365,107,0,0,465,1274,1739,408,298,706
129,364,360,0,0,325,338,663,191,1044,1235
606,364,312,1,0,70,809,879,155,705,860
712,364,74,0,0,563,601,1164,203,230,433
907,364,79,0,0,320,955,1275,279,315,594
1803,364,241,1,2,776,0,776,434,0,434
645,363,467,1,0,823,0,823,642,1346,1988
1232,363,232,1,0,672,298,970,644,391,1035
1353,363,87,0,0,454,1263,1717,217,292,509
2552,363,108,1,0,8,1657,1665,33,208,241
1238,362,122,0,0,9,893,902,64,318,382
1368,362,280,1,2,285,662,947,206,685,891
1889,362,241,1,0,132,1429,1561,132,622,754
2686,362,91,0,0,199,1943,2142,115,121,236
2797,362,89,0,0,89,846,935,37,193,230
3518,362,275,1,2,24,846,870,51,704,755
632,361,135,1,2,89,880,969,92,344,436
1336,361,184,0,0,527,788,1315,220,174,394
2675,361,74,0,0,11,1017,1028,6,123,129
2896,361,211,1,2,669,1475,2144,281,535,816
535,360,146,1,0,7,880,887,105,416,521
753,360,57,0,0,1850,1079,2929,125,28,153
1926,360,54,0,0,104,1079,1183,181,260,441
533,359,56,0,1,820,88,908,217,137,354
302,358,128,0,0,1535,501,2036,234,73,307
3657,358,104,1,0,18,1585,1603,17,179,196
1070,357,239,1,2,314,780,1094,216,526,742
1433,357,83,1,2,99,1240,1339,76,301,377
1879,357,162,1,2,1287,1468,2755,491,201,692
1151,356,117,1,0,720,823,1543,251,249,500
979,355,60,1,2,524,398,922,74,0,74
1335,355,360,1,2,103,935,1038,205,712,917
1469,355,233,0,0,1102,0,1102,1500,1114,2614
2172,355,145,1,2,100,1096,1196,79,408,487
2269,355,107,0,0,16,1464,1480,35,183,218
3540,355,70,0,0,977,1149,2126,134,50,184
2465,354,297,1,2,321,1089,1410,77,772,849
3597,354,102,0,0,219,1260,1479,197,280,477
3686,353,5,0,0,2,1188,1190,5,10,15
566,352,168,0,0,928,456,1384,371,350,721
756,352,275,1,2,207,937,1144,97,939,1036
1688,352,134,0,0,553,503,1056,665,761,1426
2293,352,66,1,2,150,871,1021,162,63,225
932,351,69,1,0,266,1827,2093,11,126,137
3506,351,283,1,0,211,844,1055,91,658,749
133,350,185,1,0,539,413,952,442,506,948
296,350,355,0,0,194,564,758,282,1386,1668
1727,350,168,1,2,16,924,940,34,451,485
2032,350,160,0,1,702,89,791,517,178,695
187,349,298,0,0,567,114,681,1011,680,1691
880,349,94,0,1,872,374,1246,282,115,397
1429,349,348,1,2,505,238,743,499,613,1112
2044,349,294,1,2,363,357,720,387,905,1292
3235,349,186,1,0,265,534,799,144,419,563
2346,348,115,1,0,49,988,1037,76,243,319
761,347,35,0,1,1505,226,1731,230,179,409
2065,347,225,1,2,246,291,537,216,381,597
3900,347,253,1,2,64,1318,1382,27,935,962
882,346,129,0,1,942,0,942,340,0,340
2092,346,129,0,0,248,1660,1908,79,269,348
599,345,51,0,1,1836,488,2324,233,172,405
885,345,430,1,2,1001,55,1056,1239,1173,2412
1921,345,273,1,2,358,617,975,351,547,898
3887,345,9,1,0,43,552,595,9,2,11
119,344,244,1,2,108,1273,1381,87,539,626
350,344,177,0,0,711,170,881,936,558,1494
1260,344,447,1,0,28,564,592,47,1289,1336
942,343,380,1,2,400,848,1248,378,559,937
1268,343,231,1,0,671,96,767,897,577,1474
1454,343,345,2,1,1489,262,1751,890,56,946
2163,343,146,0,0,516,1093,1609,551,822,1373
292,342,116,1,2,859,0,859,179,0,179
1581,342,54,1,0,524,862,1386,54,37,91
1691,342,10,1,2,30,959,989,10,3,13
1885,342,293,1,0,12,739,751,24,867,891
2403,342,77,0,0,1215,1362,2577,309,289,598
3286,342,84,0,0,194,1092,1286,115,165,280
3507,342,91,0,0,126,1827,1953,85,276,361
3725,342,100,0,0,134,939,1073,194,334,528
3797,342,168,1,1,69,732,801,76,448,524
1262,341,93,1,2,888,26,914,193,60,253
1369,341,190,0,0,517,378,895,361,331,692
3632,341,67,0,0,300,1119,1419,52,58,110
3723,341,251,1,2,93,605,698,149,386,535
3866,341,255,1,0,9,675,684,76,506,582
102,340,86,1,0,524,33,557,49,126,175
813,340,251,0,0,661,0,661,614,0,614
2826,340,263,1,2,28,1152,1180,80,715,795
3316,340,205,1,2,97,911,1008,109,323,432
3938,340,166,1,2,81,965,1046,68,298,366
582,339,340,0,0,593,218,811,1619,1573,3192
1479,339,90,0,1,732,53,785,135,15,150
1531,339,159,1,0,429,730,1159,188,156,344
2133,339,367,1,0,71,793,864,120,1143,1263
503,338,160,0,1,654,82,736,1083,653,1736
622,338,73,0,0,184,1108,1292,63,115,178
1439,338,97,0,0,40,824,864,142,442,584
1595,337,51,0,0,615,1128,1743,239,11,250
2356,337,75,1,2,25,1718,1743,21,180,201
3424,337,135,0,0,402,359,761,115,255,370
23,336,336,1,0,539,16,555,561,640,1201
657,336,180,1,2,346,500,846,179,525,704
748,336,199,1,0,103,678,781,97,362,459
1101,336,240,1,0,205,521,726,385,488,873
2156,336,168,0,1,1165,170,1335,517,193,710
2117,335,32,0,1,1923,636,2559,136,101,237
3700,335,81,0,0,671,629,1300,116,53,169
334,334,183,1,2,1036,195,1231,558,15,573
3240,334,185,0,2,57,1680,1737,74,645,719
3621,334,212,0,0,191,899,1090,167,576,743
1658,333,76,0,0,447,583,1030,327,144,471
2530,333,58,0,0,7,897,904,104,201,305
2543,333,5,1,2,3,972,975,0,5,5
2956,333,32,0,0,71,1667,1738,23,63,86
259,332,357,2,1,3171,449,3620,2394,231,2625
2223,332,112,0,0,251,775,1026,120,250,370
2884,332,166,0,0,129,1065,1194,48,413,461
59,331,253,1,0,445,111,556,196,785,981
278,331,120,0,0,155,722,877,167,310,477
2331,331,95,0,0,117,1097,1214,243,303,546
148,330,84,0,1,667,1,668,258,101,359
192,330,347,1,2,578,3,581,507,1113,1620
2112,330,89,1,2,313,1250,1563,212,20,232
2723,330,145,1,2,160,894,1054,117,378,495
3145,330,83,1,1,14,656,670,9,185,194
400,329,267,1,2,495,364,859,402,908,1310
1092,329,285,1,2,54,904,958,52,846,898
1230,329,65,0,0,258,770,1028,132,110,242
2680,329,286,1,2,155,643,798,136,724,860
2804,329,257,1,0,2,1000,1002,23,1097,1120
3134,329,37,0,0,690,3,693,146,92,238
3254,329,25,0,0,56,986,1042,18,43,61
3451,328,64,1,2,65,1107,1172,14,928,942
349,327,36,0,0,1247,447,1694,59,8,67
3099,327,155,0,0,470,1120,1590,571,796,1367
3213,326,83,0,0,916,662,1578,326,271,597
884,325,383,1,0,308,226,534,421,747,1168
1820,325,64,0,0,24,892,916,14,141,155
796,324,88,0,0,50,591,641,77,170,247
1135,324,207,1,2,10,1040,1050,16,654,670
352,323,38,0,0,1662,887,2549,275,18,293
636,323,262,1,2,898,0,898,470,0,470
1444,323,50,0,0,617,1383,2000,156,205,361
1497,323,25,0,0,0,1165,1165,11,39,50
1538,323,284,1,0,84,566,650,169,750,919
409,322,57,0,0,1022,616,1638,203,217,420
792,322,436,1,2,501,243,744,569,978,1547
3803,322,198,1,0,34,1153,1187,58,617,675
1041,321,174,1,2,91,943,1034,51,385,436
1723,321,214,1,2,244,353,597,150,353,503
1858,321,211,2,1,4389,0,4389,876,0,876
1863,321,157,0,0,381,494,875,636,305,941
633,320,32,0,1,1683,18,1701,130,80,210
639,320,107,1,0,324,235,559,135,64,199
2534,320,55,0,1,565,1,566,150,64,214
2840,320,327,1,0,123,889,1012,156,779,935
570,319,185,0,0,887,746,1633,486,709,1195
2565,319,190,1,2,363,331,694,307,397,704
685,318,63,0,0,1540,32,1572,1273,1238,2511
1045,318,211,0,1,1024,60,1084,761,336,1097
2311,318,196,0,0,219,906,1125,457,954,1411
2316,318,25,0,0,456,1517,1973,164,175,339
3560,318,44,0,0,143,1494,1637,21,67,88
1467,317,42,1,2,20,903,923,22,63,85
3079,317,139,1,0,110,1635,1745,32,634,666
3378,317,127,0,0,1093,615,1708,387,314,701
509,316,86,0,1,1287,0,1287,304,0,304
1873,316,197,1,0,147,518,665,299,512,811
3498,316,81,0,0,1035,406,1441,729,596,1325
150,315,205,0,0,1160,137,1297,742,604,1346
397,315,87,0,0,664,985,1649,203,216,419
541,315,158,0,0,516,531,1047,271,355,626
2930,315,114,0,1,698,191,889,307,312,619
3160,315,115,1,1,1517,781,2298,422,53,475
85,314,59,0,0,34,843,877,68,135,203
1850,314,11,0,0,76,2355,2431,10,6,16
146,313,16,0,0,0,1341,1341,0,19,19
2409,313,39,0,1,769,5,774,948,884,1832
3089,313,138,0,0,26,1249,1275,42,315,357
2125,312,130,0,1,609,95,704,586,364,950
2969,312,204,0,0,97,802,899,82,553,635
3411,312,78,0,0,427,390,817,545,469,1014
1620,311,294,1,2,53,614,667,92,683,775
1738,311,12,0,0,2,1321,1323,5,16,21
2940,311,122,1,2,5,1284,1289,50,441,491
417,310,277,1,2,125,468,593,181,586,767
768,310,236,1,0,52,499,551,141,417,558
719,309,101,0,0,1142,138,1280,1986,1874,3860
841,309,104,0,0,416,294,710,164,50,214
1150,309,54,0,0,323,1139,1462,97,81,178
832,308,490,1,2,608,113,721,600,1368,1968
3510,308,171,0,0,145,821,966,274,616,890
987,307,175,0,0,510,86,596,1424,1086,2510
1171,307,126,0,0,434,89,523,206,44,250
2353,307,229,0,0,659,987,1646,922,705,1627
3883,306,288,1,0,110,885,995,66,985,1051
42,305,137,0,0,241,336,577,316,553,869
186,305,284,1,0,706,94,800,1186,529,1715
198,305,195,1,0,0,726,726,62,554,616
396,305,123,0,0,626,736,1362,251,302,553
924,305,249,1,2,128,461,589,264,522,786
1037,305,92,0,1,8,890,898,38,179,217
2364,305,104,0,0,144,947,1091,218,188,406
70,304,456,2,1,835,1311,2146,1547,4,1551
1007,304,45,0,0,66,582,648,390,466,856
1292,304,224,0,0,1115,95,1210,1345,634,1979
1478,304,260,0,0,555,711,1266,596,389,985
1666,304,146,0,0,579,387,966,308,295,603
1915,304,124,1,1,318,835,1153,26,171,197
2028,304,108,0,1,1476,701,2177,225,1,226
776,303,146,0,0,354,398,752,470,434,904
1855,303,72,1,0,568,192,760,140,39,179
1947,303,370,1,2,164,639,803,77,1310,1387
469,302,60,0,1,1086,34,1120,338,326,664
482,302,108,0,1,792,0,792,162,0,162
525,302,133,0,0,537,141,678,223,143,366
1888,302,131,0,0,329,1835,2164,150,384,534
558,301,37,0,0,321,904,1225,71,98,169
2549,301,143,0,0,3,733,736,6,306,312
3619,301,158,1,2,169,436,605,518,171,689
1488,300,105,0,0,237,699,936,215,222,437
1562,300,202,1,2,163,863,1026,100,482,582
2174,300,255,1,2,302,254,556,377,473,850
2574,300,199,1,2,128,653,781,92,427,519
3429,300,289,1,2,134,587,721,109,942,1051
166,298,126,0,0,188,439,627,348,297,645
1674,298,139,0,0,1126,384,1510,338,294,632
2013,298,76,0,0,419,821,1240,279,362,641
3730,298,404,1,0,436,185,621,411,947,1358
662,297,164,0,0,358,663,1021,295,512,807
1842,297,103,1,2,274,474,748,93,82,175
3230,297,206,1,2,142,684,826,127,575,702
1334,296,269,1,2,194,904,1098,183,863,1046
1959,296,30,0,0,2075,1397,3472,205,156,361
3533,296,18,0,0,3,1201,1204,8,21,29
3623,296,278,1,2,1160,755,1915,507,969,1476
1451,295,77,0,0,439,898,1337,136,86,222
1476,295,167,0,0,310,314,624,585,295,880
1642,295,251,1,0,144,422,566,407,712,1119
1813,295,77,0,1,921,391,1312,410,341,751
1866,295,230,0,0,828,20,848,870,810,1680
2297,295,97,0,1,1051,603,1654,582,401,983
2772,295,200,0,1,25,610,635,109,804,913
3461,295,169,0,0,11,814,825,57,393,450
3778,295,94,1,0,434,876,1310,119,149,268
403,293,133,1,2,22,1192,1214,74,358,432
572,293,210,1,2,329,241,570,426,273,699
1006,293,34,0,0,480,465,945,75,44,119
293,292,249,1,2,395,459,854,199,629,828
1473,292,109,0,0,285,484,769,79,84,163
1786,292,24,0,0,145,948,1093,115,132,247
3516,292,107,0,0,423,680,1103,471,522,993
72,291,109,0,0,819,0,819,210,0,210
994,291,308,1,2,88,545,633,95,848,943
2436,291,126,1,2,9,984,993,4,285,289
3084,291,274,1,2,381,198,579,624,219,843
1173,290,32,0,0,820,1008,1828,188,158,346
1222,290,156,0,0,395,223,618,886,623,1509
1799,290,199,0,0,121,670,791,129,530,659
3423,290,173,0,0,125,603,728,741,1069,1810
80,289,132,0,0,1005,449,1454,359,232,591
2794,289,43,0,0,192,1459,1651,46,37,83
3060,289,56,0,0,164,631,795,267,236,503
874,288,121,1,2,639,190,829,160,7,167
1704,288,118,1,0,224,352,576,325,334,659
2121,288,28,0,0,424,1076,1500,61,50,111
26,287,88,0,0,124,1185,1309,116,139,255
859,287,19,0,1,598,0,598,402,380,782
1265,287,180,1,0,407,80,487,325,214,539
3255,287,30,0,0,36,1052,1088,45,75,120
1352,286,111,0,0,659,408,1067,538,470,1008
1435,286,142,1,2,115,896,1011,144,404,548
704,285,171,0,1,879,54,933,1236,535,1771
1410,285,202,0,0,405,299,704,474,548,1022
2363,285,92,1,0,11,767,778,38,194,232
522,284,431,1,2,398,117,515,335,1266,1601
872,284,137,0,0,194,853,1047,148,194,342
1046,284,145,0,0,652,222,874,287,224,511
3522,284,22,0,0,44,1185,1229,6,23,29
585,283,99,0,0,95,1132,1227,39,297,336
1130,283,37,0,1,1269,0,1269,52,0,52
1933,283,233,1,2,1067,0,1067,1300,0,1300
3149,283,75,0,1,494,0,494,96,0,96
754,282,56,0,0,62,933,995,93,176,269
1058,282,43,0,0,125,707,832,192,210,402
1553,282,189,1,2,7,585,592,65,484,549
1659,282,181,0,0,307,206,513,373,347,720
1756,282,130,0,0,204,457,661,341,280,621
946,281,67,0,0,704,79,783,140,70,210
1089,281,122,0,0,210,383,593,438,437,875
1269,281,41,0,0,118,664,782,345,389,734
1646,281,376,1,2,229,360,589,549,940,1489
1924,281,13,0,0,19,923,942,7,20,27
2196,281,42,0,1,964,28,992,117,53,170
2219,281,321,1,2,135,417,552,155,957,1112
3336,281,99,0,0,1074,315,1389,115,160,275
3523,281,149,0,0,866,475,1341,727,697,1424
1464,280,99,0,1,506,96,602,172,5,177
1807,280,133,0,0,539,197,736,470,407,877
1178,279,86,0,0,960,584,1544,363,279,642
1357,279,232,2,2,1017,133,1150,527,54,581
1422,279,345,1,2,295,211,506,555,679,1234
1452,279,176,0,0,534,410,944,162,188,350
1494,279,227,2,1,2316,467,2783,697,8,705
1697,279,466,1,0,427,42,469,116,1820,1936
138,278,74,0,0,736,157,893,1005,976,1981
651,278,107,0,0,73,955,1028,201,392,593
844,278,221,1,2,213,256,469,217,278,495
2559,278,60,0,1,379,474,853,124,66,190
3186,278,124,0,0,375,887,1262,136,335,471
3869,278,261,1,0,42,523,565,207,888,1095
348,277,42,0,0,1673,0,1673,63,0,63
426,277,181,1,2,243,266,509,261,713,974
557,277,119,0,0,822,1648,2470,327,498,825
1044,277,91,0,1,1357,896,2253,744,740,1484
2141,277,134,1,2,154,286,440,276,447,723
3492,277,234,0,0,39,514,553,367,956,1323
583,276,161,1,0,1,689,690,6,529,535
771,276,113,0,1,1180,421,1601,1104,1056,2160
967,276,38,0,0,1022,301,1323,94,73,167
1005,276,33,0,1,780,184,964,556,501,1057
1138,276,290,0,0,101,688,789,292,980,1272
1426,276,168,0,0,248,478,726,484,627,1111
1639,276,110,1,1,376,236,612,333,292,625
19,275,257,1,2,662,0,662,383,310,693
1340,275,183,0,0,210,399,609,129,535,664
3670,275,88,0,0,171,920,1091,139,256,395
1389,274,220,1,2,13,698,711,37,462,499
1403,274,272,0,0,819,432,1251,576,322,898
1463,274,99,0,0,806,378,1184,782,731,1513
2693,274,40,0,0,1120,619,1739,373,356,729
170,273,47,0,0,946,546,1492,62,6,68
251,273,281,2,1,1396,983,2379,1374,208,1582
1533,273,101,0,0,316,398,714,686,473,1159
3959,273,158,0,0,336,290,626,508,459,967
435,272,141,0,1,905,367,1272,670,476,1146
741,272,142,1,0,326,175,501,264,90,354
845,272,51,0,1,618,0,618,67,0,67
1489,272,134,0,0,507,136,643,332,359,691
3472,272,210,0,0,194,349,543,549,637,1186
1246,271,90,0,1,721,296,1017,577,706,1283
211,270,153,1,0,153,503,656,105,254,359
1549,270,65,0,0,228,735,963,105,193,298
1614,270,152,1,0,1422,352,1774,677,445,1122
758,269,196,0,1,15,799,814,132,584,716
787,269,37,0,1,479,419,898,48,39,87
1969,269,215,1,0,77,620,697,77,664,741
3360,269,318,1,0,268,345,613,310,1162,1472
1609,268,78,0,0,190,1165,1355,31,220,251
3538,268,278,0,0,361,402,763,314,855,1169
770,267,194,0,0,354,174,528,165,751,916
1709,267,81,0,0,554,288,842,208,186,394
2078,267,77,0,0,123,870,993,131,125,256
195,266,156,0,0,246,204,450,146,484,630
486,266,235,1,2,57,466,523,43,705,748
2842,266,69,0,1,803,370,1173,227,171,398
1094,265,330,0,0,46,464,510,112,872,984
1134,265,123,0,0,83,983,1066,68,289,357
2337,265,257,1,1,148,315,463,420,649,1069
1228,264,110,0,1,576,137,713,694,809,1503
1237,264,184,0,0,377,283,660,1063,772,1835
1648,264,83,0,0,402,580,982,173,272,445
1939,264,78,0,1,506,381,887,197,73,270
604,263,275,1,2,798,0,798,1305,0,1305
800,263,98,0,0,591,470,1061,434,562,996
1031,263,61,0,0,535,79,614,149,120,269
1974,263,157,0,0,253,270,523,143,73,216
3434,263,54,0,1,93,684,777,57,86,143
3437,263,109,0,0,83,444,527,264,556,820
1366,262,162,0,0,168,472,640,288,508,796
3611,262,11,0,1,423,1319,1742,0,41,41
184,261,296,2,1,828,369,1197,772,351,1123
401,261,311,1,0,277,216,493,174,830,1004
743,261,165,0,0,19,419,438,37,360,397
1798,261,22,0,0,148,1101,1249,86,126,212
2731,261,330,1,2,198,364,562,227,965,1192
424,260,142,0,0,593,48,641,683,583,1266
2631,260,22,0,1,670,321,991,178,158,336
328,259,141,0,0,922,389,1311,655,517,1172
442,259,116,0,0,389,473,862,108,226,334
716,259,98,0,1,816,0,816,310,0,310
1878,259,67,0,0,233,828,1061,68,125,193
3914,259,85,1,0,292,219,511,263,209,472
605,258,28,0,1,1248,614,1862,75,34,109
1628,258,16,0,0,47,1261,1308,9,30,39
2137,258,329,1,1,11,604,615,71,1247,1318
3124,258,165,0,0,637,779,1416,384,700,1084
518,257,145,0,1,1030,303,1333,1140,980,2120
1267,257,112,0,1,678,280,958,562,748,1310
1618,257,50,0,0,874,796,1670,120,78,198
2178,257,21,0,0,31,662,693,10,27,37
3100,257,87,0,0,85,490,575,115,296,411
177,256,137,1,2,205,507,712,120,191,311
250,256,260,2,1,2138,1442,3580,921,68,989
1623,256,63,0,1,1243,547,1790,232,138,370
1728,256,3,0,0,72,784,856,0,5,5
2791,256,360,1,2,559,10,569,221,866,1087
3116,256,93,0,1,610,17,627,350,168,518
94,255,274,2,1,1177,474,1651,1163,279,1442
2413,255,14,0,1,172,1278,1450,33,0,33
3086,255,78,0,0,254,499,753,438,551,989
3325,254,297,1,0,161,521,682,141,1050,1191
3824,254,47,1,0,0,585,585,1,64,65
1715,253,404,1,0,317,140,457,1252,90,1342
2578,253,183,2,1,2649,143,2792,693,128,821
3241,253,87,0,0,80,742,822,267,443,710
3692,253,73,0,2,844,54,898,116,0,116
3832,253,61,0,0,1065,470,1535,690,632,1322
589,252,37,0,1,424,27,451,388,318,706
1085,252,104,1,1,717,27,744,384,289,673
1507,252,55,1,0,445,251,696,53,36,89
2145,252,119,1,1,830,161,991,326,236,562
3304,252,108,0,0,549,559,1108,900,756,1656
3321,252,251,1,0,7,475,482,36,568,604
3599,252,92,0,0,2,784,786,49,293,342
1449,251,244,1,0,33,469,502,108,556,664
271,250,127,1,2,351,151,502,476,485,961
530,250,85,0,1,638,213,851,384,222,606
1363,250,163,0,0,116,554,670,286,457,743
2195,250,210,1,1,300,388,688,169,492,661
380,249,39,0,0,446,1458,1904,23,67,90
185,248,125,0,0,627,0,627,364,0,364
615,248,336,1,2,313,544,857,117,765,882
1176,248,173,0,0,273,470,743,779,315,1094
1424,248,189,2,1,692,48,740,443,71,514
573,247,355,0,2,477,1485,1962,748,2,750
1087,247,129,0,1,1091,395,1486,1164,480,1644
2900,247,21,0,0,65,712,777,48,70,118
1722,246,68,0,0,86,524,610,60,76,136
2260,246,29,0,1,1123,483,1606,249,203,452
169,245,260,1,0,52,347,399,60,666,726
1883,245,76,1,2,968,584,1552,221,205,426
3769,245,28,1,0,2,520,522,0,56,56
643,244,54,0,1,474,4,478,102,30,132
1250,244,329,1,2,21,383,404,72,983,1055
1492,244,119,0,0,166,238,404,249,415,664
3455,244,114,0,0,514,319,833,622,649,1271
3957,244,65,0,1,265,369,634,113,281,394
863,243,275,1,0,10,571,581,48,1137,1185
1102,243,101,1,0,16,1302,1318,27,234,261
1115,243,60,0,1,1002,291,1293,106,20,126
2743,243,296,1,2,71,681,752,141,1045,1186
2941,243,77,0,1,780,458,1238,587,337,924
3688,243,326,2,1,14,618,632,91,721,812
631,242,236,1,0,33,462,495,69,431,500
936,242,32,0,0,706,0,706,40,0,40
1077,242,195,1,2,59,1059,1118,85,680,765
3029,242,48,0,0,26,703,729,10,123,133
3625,242,89,0,0,417,1004,1421,631,769,1400
3865,242,310,1,1,29,318,347,41,638,679
1081,241,58,0,0,270,726,996,106,123,229
1681,241,225,0,0,261,657,918,841,436,1277
2187,241,140,1,2,566,0,566,232,0,232
2610,241,131,2,1,1735,119,1854,286,48,334
3028,241,149,0,0,386,587,973,234,522,756
3101,241,49,0,0,681,812,1493,737,752,1489
3792,241,23,0,0,886,1429,2315,183,154,337
485,240,131,2,1,1434,46,1480,334,24,358
1732,240,98,0,0,42,680,722,104,322,426
1894,240,37,0,0,48,1818,1866,16,47,63
1934,240,16,0,0,972,1240,2212,16,4,20
816,239,127,0,0,102,323,425,151,287,438
2050,239,348,1,2,30,600,630,187,1230,1417
2381,239,245,1,2,710,0,710,521,241,762
2736,239,24,0,0,16,640,656,8,36,44
3463,239,163,1,0,47,585,632,248,564,812
353,238,105,0,1,478,296,774,134,211,345
1180,238,55,0,1,1089,40,1129,145,116,261
1603,238,65,0,0,879,576,1455,186,247,433
3452,238,260,0,0,123,786,909,62,664,726
44,237,91,0,0,417,950,1367,128,142,270
214,237,419,0,0,109,298,407,433,1187,1620
905,237,162,2,1,1035,216,1251,689,241,930
1328,237,56,0,1,1193,850,2043,175,50,225
2861,237,43,0,1,941,17,958,193,121,314
3665,237,131,1,0,78,706,784,56,307,363
308,236,76,1,2,480,0,480,112,0,112
1051,236,95,0,1,376,171,547,152,60,212
1460,236,10,0,0,63,1311,1374,622,623,1245
2118,236,117,0,1,473,542,1015,751,558,1309
780,235,103,0,0,350,71,421,93,114,207
1836,235,498,2,0,834,371,1205,1326,103,1429
2916,235,122,0,0,176,412,588,354,225,579
314,234,70,0,0,444,534,978,123,38,161
1354,234,104,0,0,99,541,640,226,383,609
1470,234,100,0,0,494,779,1273,372,405,777
1534,234,348,1,2,11,410,421,92,1157,1249
1891,234,116,2,1,5,568,573,65,293,358
2250,234,230,1,2,527,0,527,411,0,411
2931,234,220,1,2,7,545,552,23,587,610
4,233,117,0,0,284,540,824,271,488,759
875,233,113,0,0,646,215,861,272,251,523
457,232,142,0,0,303,398,701,1093,733,1826
462,232,232,2,1,885,457,1342,774,301,1075
610,232,56,0,0,432,267,699,208,133,341
1114,232,41,0,1,1004,767,1771,82,53,135
1154,232,119,0,0,273,273,546,576,580,1156
1395,232,87,0,0,222,157,379,140,161,301
1437,232,75,1,0,1,1064,1065,25,314,339
1572,232,101,2,1,358,615,973,331,110,441
1588,232,103,0,0,382,257,639,423,319,742
1516,231,369,1,2,118,250,368,307,894,1201
1522,231,370,1,2,388,10,398,421,956,1377
1647,231,373,0,0,38,348,386,249,1107,1356
1989,231,141,0,0,93,1191,1284,103,582,685
3096,231,71,0,1,555,325,880,404,407,811
3691,231,41,0,0,468,1410,1878,31,76,107
540,230,105,0,1,925,778,1703,347,394,741
2248,230,89,0,0,579,661,1240,274,82,356
2319,230,97,2,1,203,748,951,207,72,279
3854,230,52,0,0,203,462,665,179,234,413
279,229,451,2,1,636,324,960,1552,26,1578
1767,229,205,0,0,691,518,1209,317,436,753
2470,229,101,1,2,595,0,595,218,0,218
284,228,27,1,0,2,748,750,1,31,32
1561,228,290,1,0,25,644,669,166,1458,1624
1622,228,64,0,0,733,421,1154,237,112,349
2276,228,84,0,0,240,490,730,358,464,822
2696,228,40,0,1,466,710,1176,679,697,1376
3085,228,54,0,0,150,539,689,54,139,193
97,227,246,2,1,2100,819,2919,800,70,870
112,227,210,0,0,282,156,438,195,822,1017
139,227,63,0,0,302,509,811,339,395,734
466,227,5,1,2,12,784,796,4,1,5
752,227,65,0,1,314,307,621,313,376,689
1633,227,81,0,0,92,804,896,64,256,320
2161,227,237,1,0,147,452,599,548,669,1217
3243,227,274,1,2,52,504,556,90,856,946
3907,227,39,2,1,10,1068,1078,16,71,87
4027,227,48,0,0,273,378,651,238,299,537
546,226,252,1,2,59,324,383,140,513,653
721,226,142,0,0,92,456,548,271,675,946
995,226,53,1,1,44,403,447,10,138,148
1223,226,35,0,0,18,488,506,13,93,106
1523,226,25,0,0,92,456,548,40,47,87
2867,226,30,0,1,795,449,1244,312,290,602
3050,226,38,0,1,478,17,495,383,341,724
3377,226,90,0,1,841,657,1498,513,387,900
3706,226,117,0,0,13,676,689,306,643,949
1189,225,34,0,1,318,9,327,90,56,146
1431,225,177,2,1,1757,1339,3096,886,332,1218
2953,225,99,0,1,219,742,961,279,468,747
3283,225,50,0,0,375,371,746,177,156,333
98,224,70,0,2,783,0,783,102,0,102
472,224,61,2,1,40,1038,1078,21,118,139
989,224,157,1,0,296,53,349,1109,1018,2127
1297,224,152,0,1,469,329,798,383,121,504
1362,224,50,0,0,88,1111,1199,223,316,539
1481,224,98,1,0,10,681,691,6,202,208
1554,224,98,1,0,92,335,427,182,396,578
1665,224,40,0,1,657,140,797,417,344,761
2224,224,71,0,0,48,712,760,216,193,409
2388,224,23,0,1,298,610,908,120,91,211
179,223,289,2,1,1887,131,2018,2401,413,2814
2040,223,47,0,1,762,152,914,655,603,1258
2938,223,188,0,1,8,451,459,90,454,544
3359,223,61,0,0,287,924,1211,86,222,308
4053,223,108,1,2,53,1444,1497,79,250,329
495,222,36,0,0,2372,995,3367,81,36,117
747,222,300,1,2,145,210,355,155,918,1073
1517,222,84,2,1,393,995,1388,101,62,163
1669,222,46,0,0,8,514,522,22,101,123
2037,222,84,0,1,855,83,938,665,521,1186
2458,222,38,0,0,243,696,939,26,72,98
2657,222,54,1,0,48,367,415,44,61,105
3314,222,275,0,0,236,765,1001,70,931,1001
3345,222,124,1,0,73,503,576,131,495,626
3858,222,76,0,0,152,540,692,28,108,136
364,221,19,0,0,1383,1607,2990,20,8,28
624,221,129,0,1,430,0,430,427,0,427
1078,221,50,1,2,177,370,547,62,40,102
1777,221,29,1,0,296,0,296,33,0,33
1914,221,152,0,1,737,0,737,736,0,736
2031,221,100,0,1,1056,82,1138,1491,1308,2799
2347,221,52,0,0,501,424,925,206,61,267
145,220,92,1,2,109,221,330,161,209,370
964,220,114,0,0,113,712,825,266,172,438
3519,220,320,1,2,64,385,449,67,1117,1184
3667,220,90,0,0,200,436,636,80,265,345
229,219,128,2,1,2330,780,3110,550,284,834
395,219,369,2,1,2783,234,3017,2457,440,2897
797,219,122,1,0,237,85,322,304,356,660
1993,219,149,0,0,249,530,779,353,238,591
2076,219,54,2,1,184,1606,1790,84,19,103
2770,219,26,0,0,19,399,418,5,34,39
551,218,65,0,0,188,775,963,26,92,118
3458,218,80,0,0,121,846,967,88,236,324
41,217,458,2,1,1848,139,1987,1905,648,2553
420,217,120,2,1,817,352,1169,433,97,530
539,217,43,0,0,1879,1414,3293,110,32,142
553,217,204,2,1,8,1263,1271,19,524,543
1036,217,26,1,0,387,908,1295,45,42,87
1042,217,137,1,0,609,0,609,530,0,530
1208,217,78,0,0,502,333,835,469,492,961
1388,217,73,0,0,244,157,401,194,191,385
3052,217,37,0,1,32,532,564,241,303,544
3855,217,242,1,2,62,411,473,159,916,1075
313,216,208,2,1,848,225,1073,764,413,1177
826,216,40,0,0,60,486,546,16,67,83
1793,216,210,2,1,192,1037,1229,269,531,800
3436,216,117,0,0,24,692,716,38,340,378
125,215,303,2,1,918,491,1409,941,65,1006
246,215,210,2,1,587,463,1050,580,515,1095
667,215,104,1,2,442,0,442,156,0,156
1316,215,85,1,0,199,239,438,302,350,652
2698,215,33,0,0,715,694,1409,91,74,165
3056,215,82,0,1,431,853,1284,352,393,745
3257,215,62,0,0,407,478,885,388,387,775
483,214,130,2,1,391,961,1352,144,261,405
547,214,30,0,0,402,765,1167,51,54,105
1790,214,54,0,0,50,510,560,8,71,79
2372,214,214,1,0,92,441,533,85,781,866
3918,214,47,0,0,198,661,859,189,256,445
508,213,137,2,1,1468,1086,2554,217,3,220
729,213,140,0,0,143,516,659,271,393,664
899,213,28,1,1,4,585,589,14,50,64
913,213,72,2,1,743,501,1244,223,120,343
1196,213,83,0,0,431,598,1029,245,368,613
1758,213,120,2,1,38,1211,1249,59,344,403
1968,213,107,0,1,501,94,595,484,312,796
2511,213,83,0,1,462,41,503,1546,1424,2970
1996,212,34,0,0,46,606,652,77,129,206
2370,212,3,0,0,2,457,459,66,77,143
2533,212,15,0,1,244,1147,1391,153,152,305
3158,212,99,1,2,186,918,1104,186,473,659
137,211,129,0,0,256,80,336,310,12,322
231,211,63,0,0,145,729,874,52,95,147
1271,211,207,1,2,72,534,606,122,960,1082
1662,211,142,2,1,202,1005,1207,310,136,446
3640,211,213,0,0,43,317,360,226,649,875
92,210,166,0,0,32,310,342,305,676,981
408,210,48,0,0,308,70,378,95,22,117
430,210,484,1,2,286,103,389,611,1365,1976
564,210,29,0,0,227,1303,1530,146,153,299
655,210,253,0,0,81,349,430,249,878,1127
830,210,183,0,0,341,213,554,685,453,1138
881,210,34,0,0,1023,0,1023,41,0,41
3319,210,21,0,0,19,821,840,7,26,33
3353,210,150,2,1,236,939,1175,99,313,412
414,209,79,1,0,551,185,736,1716,1648,3364
501,209,217,1,0,190,207,397,466,521,987
1190,209,287,1,2,70,496,566,97,1129,1226
1274,209,79,0,0,225,218,443,161,188,349
3020,209,54,0,0,35,756,791,28,154,182
3576,209,9,0,1,126,1163,1289,5,12,17
216,208,59,0,0,236,723,959,202,178,380
480,208,115,2,1,106,979,1085,69,140,209
951,208,92,0,0,324,287,611,389,420,809
2064,208,32,0,0,1019,678,1697,141,94,235
3432,208,60,1,2,299,448,747,129,118,247
1035,207,2,0,2,2,471,473,2,4,6
1060,207,53,0,0,154,274,428,41,104,145
1908,207,3,0,0,11,996,1007,5,4,9
2813,207,55,1,2,750,1397,2147,55,100,155
3823,207,39,0,0,33,563,596,22,87,109
3922,207,81,0,0,246,450,696,567,500,1067
935,206,29,0,0,1782,886,2668,154,125,279
1717,206,35,0,1,664,1468,2132,316,349,665
1805,206,337,1,2,67,287,354,298,1034,1332
3776,206,38,0,0,7,633,640,37,243,280
240,205,47,0,1,517,338,855,152,131,283
346,205,359,2,1,937,418,1355,1290,479,1769
476,205,109,2,1,402,936,1338,267,244,511
1650,205,76,1,1,535,49,584,194,60,254
3218,205,37,0,0,46,359,405,101,225,326
3697,205,241,2,2,16,314,330,67,397,464
440,204,95,2,1,853,140,993,273,184,457
1543,204,32,1,2,2,519,521,3,57,60
3327,204,49,0,0,687,553,1240,458,412,870
3707,204,84,0,0,259,489,748,432,556,988
849,203,25,0,0,44,722,766,104,122,226
860,203,108,0,0,498,29,527,1026,956,1982
1344,203,114,2,0,314,112,426,291,39,330
1580,203,83,0,0,4,412,416,81,319,400
1847,203,79,0,0,235,179,414,140,191,331
3082,203,67,0,0,76,487,563,110,262,372
3272,203,141,1,0,402,0,402,281,0,281
857,202,44,0,0,34,506,540,182,229,411
1778,202,45,0,1,335,636,971,324,244,568
1864,202,38,0,0,1091,1717,2808,313,274,587
3285,202,95,2,1,5,1697,1702,75,338,413
3439,202,68,1,0,109,880,989,50,102,152
3445,202,246,0,0,67,587,654,81,692,773
3466,202,22,0,1,143,972,1115,142,163,305
3583,202,293,1,2,21,521,542,18,1040,1058
392,201,120,0,1,690,266,956,538,428,966
1904,201,171,2,0,497,158,655,647,622,1269
2000,201,236,1,0,175,123,298,505,685,1190
2556,201,71,0,1,383,199,582,148,76,224
3950,201,114,2,1,130,1079,1209,80,325,405
579,200,66,0,1,448,87,535,430,281,711
1760,200,135,2,1,41,1044,1085,83,296,379
2980,200,165,0,0,1,345,346,43,287,330
3027,200,285,1,0,3,405,408,58,1025,1083
3391,200,85,0,0,261,325,586,179,222,401
3426,200,36,0,1,497,74,571,1617,1572,3189
2005,199,94,0,0,251,391,642,186,336,522
3022,199,67,0,1,345,4,349,397,297,694
840,198,95,0,0,196,680,876,60,192,252
1458,198,79,0,0,307,311,618,48,169,217
3850,198,148,2,1,70,1194,1264,87,307,394
534,197,138,0,2,712,346,1058,286,193,479
1345,197,62,0,0,197,1026,1223,45,149,194
1428,197,126,0,0,232,286,518,337,472,809
1776,197,35,1,2,68,652,720,45,18,63
2231,197,30,0,1,518,16,534,657,622,1279
2503,197,205,1,2,96,242,338,95,545,640
3690,197,48,0,0,512,150,662,76,9,85
834,196,181,2,1,1109,350,1459,1341,182,1523
1331,196,269,2,1,782,201,983,380,1274,1654
1390,196,109,1,2,657,0,657,282,0,282
2302,196,7,0,1,505,97,602,79,71,150
2429,196,94,2,1,127,1208,1335,164,159,323
2788,196,26,0,0,71,700,771,57,93,150
208,195,113,0,1,733,221,954,361,378,739
498,195,229,2,1,838,363,1201,930,282,1212
799,195,153,1,2,213,221,434,189,222,411
1064,195,213,0,0,16,311,327,27,598,625
1486,195,209,1,0,9,553,562,43,565,608
1729,195,177,2,1,424,57,481,349,94,443
2238,195,60,0,0,77,597,674,39,102,141
2718,195,17,0,0,232,985,1217,22,4,26
3217,195,52,0,1,278,588,866,78,19,97
3226,195,16,0,0,312,255,567,20,5,25
3744,195,178,1,2,413,0,413,505,0,505
2111,194,64,1,0,286,213,499,181,167,348
3081,194,105,0,0,51,504,555,159,446,605
3210,194,105,1,2,96,358,454,107,309,416
742,193,96,1,2,4,515,519,4,179,183
1657,193,52,0,0,24,741,765,22,85,107
1774,193,115,2,1,450,206,656,378,107,485
1313,192,41,0,0,331,457,788,54,51,105
1447,192,81,0,1,397,30,427,346,210,556
1600,192,25,0,1,565,3,568,54,8,62
2579,192,27,0,0,328,1383,1711,39,19,58
2659,192,168,2,1,98,834,932,149,555,704
2958,192,17,0,0,1523,870,2393,28,15,43
2981,192,92,0,1,447,187,634,1059,968,2027
3354,192,144,2,1,230,357,587,358,363,721
3759,192,153,0,0,28,406,434,336,807,1143
3831,192,136,2,1,226,531,757,312,261,573
883,191,39,0,0,319,520,839,254,318,572
1310,191,116,0,0,334,268,602,318,320,638
1358,191,97,0,0,86,266,352,339,472,811
2892,191,23,0,1,206,848,1054,37,1,38
3135,191,60,0,0,245,240,485,283,291,574
188,190,63,0,0,33,389,422,64,147,211
603,190,136,0,0,4,424,428,8,292,300
1511,190,320,1,0,262,31,293,482,899,1381
1796,190,98,2,1,87,778,865,92,89,181
2591,190,108,0,0,163,337,500,415,559,974
2926,190,15,0,0,162,2239,2401,20,24,44
789,189,238,2,1,362,335,697,659,576,1235
1186,189,100,0,0,453,149,602,824,644,1468
1411,189,16,0,0,0,665,665,40,17,57
1584,189,28,0,0,249,590,839,32,54,86
2368,189,82,1,2,278,397,675,55,216,271
3735,189,100,0,0,114,223,337,75,173,248
3878,189,26,0,1,381,40,421,239,203,442
3896,189,6,2,1,16,1233,1249,24,23,47
237,188,165,2,1,265,298,563,434,533,967
241,188,239,2,1,972,9,981,548,710,1258
260,188,167,2,1,852,422,1274,1462,349,1811
1177,188,24,0,1,272,30,302,152,112,264
1712,188,64,0,1,335,80,415,71,22,93
2520,188,30,0,0,535,719,1254,53,23,76
3128,188,154,0,0,249,322,571,465,789,1254
3296,188,43,0,1,351,74,425,471,445,916
3754,188,30,0,0,716,203,919,94,91,185
343,187,105,2,1,365,389,754,390,11,401
696,187,160,2,1,1045,798,1843,671,231,902
895,187,57,0,0,162,520,682,42,43,85
952,187,74,2,1,160,1129,1289,282,1,283
2122,187,30,0,0,59,580,639,18,70,88
2540,187,23,0,0,624,829,1453,73,41,114
2602,187,32,0,0,264,419,683,124,109,233
3671,187,126,0,0,324,154,478,534,328,862
3699,187,149,2,1,166,1045,1211,225,289,514
647,186,123,0,0,110,418,528,164,437,601
968,186,164,0,0,360,77,437,714,337,1051
1972,186,82,0,1,1652,834,2486,237,65,302
3430,186,235,1,2,16,297,313,250,760,1010
3606,186,41,0,0,43,787,830,35,85,120
1075,185,56,1,2,318,2,320,83,22,105
1443,185,134,2,1,4,1203,1207,8,305,313
1453,185,67,0,0,104,446,550,54,149,203
2292,185,31,2,0,362,0,362,46,8,54
2611,185,131,2,1,1401,555,1956,501,65,566
3986,185,31,0,0,552,130,682,161,143,304
4034,185,86,2,1,491,462,953,305,103,408
763,184,55,1,0,22,495,517,146,265,411
814,184,500,0,0,436,1,437,2115,130,2245
866,184,287,0,0,237,571,808,474,116,590
1952,184,228,2,1,210,332,542,391,594,985
3284,184,39,0,0,271,1035,1306,260,271,531
3605,184,322,1,2,97,218,315,72,1853,1925
876,183,55,2,1,1261,4,1265,191,91,282
877,183,52,0,1,280,53,333,195,142,337
1295,183,281,0,1,530,635,1165,629,10,639
1466,183,262,0,0,29,344,373,68,485,553
2490,183,82,0,1,536,442,978,721,559,1280
321,182,136,2,1,638,1098,1736,292,354,646
477,182,295,2,1,1016,91,1107,837,359,1196
561,182,77,2,1,598,620,1218,204,79,283
1025,182,108,0,0,319,495,814,279,259,538
1033,182,140,2,1,215,305,520,401,213,614
1556,182,41,0,1,853,357,1210,274,216,490
1608,182,113,0,0,12,417,429,21,172,193
2079,182,46,0,1,124,514,638,238,235,473
2369,182,74,0,0,459,0,459,260,0,260
38,181,52,0,0,18,452,470,20,92,112
262,181,84,0,1,459,2161,2620,215,124,339
281,181,36,0,0,420,19,439,41,10,51
528,181,152,2,1,120,637,757,116,185,301
720,181,102,0,0,273,128,401,1326,1348,2674
1022,181,38,0,0,256,106,362,130,103,233
1206,181,81,0,0,323,447,770,59,115,174
1621,181,76,1,0,15,312,327,133,212,345
1794,181,90,0,0,87,357,444,63,308,371
2057,181,24,0,1,659,206,865,43,16,59
2159,181,135,0,1,568,64,632,965,858,1823
2300,181,18,0,1,786,680,1466,67,44,111
3399,181,138,2,1,27,993,1020,41,293,334
84,180,70,0,0,5,535,540,6,150,156
226,180,133,0,0,407,358,765,229,505,734
690,180,35,0,1,498,182,680,120,95,215
2220,180,96,2,1,229,940,1169,155,233,388
3004,180,75,0,0,131,408,539,311,441,752
3059,180,68,0,0,67,420,487,111,184,295
74,179,52,0,0,107,238,345,454,500,954
434,179,239,2,1,372,522,894,526,399,925
617,179,136,0,1,1380,619,1999,549,270,819
708,179,46,0,1,328,86,414,118,59,177
1013,179,261,1,0,177,230,407,140,738,878
1307,179,139,0,0,202,225,427,169,288,457
3422,179,24,0,1,74,376,450,5,27,32
1555,178,176,2,0,190,723,913,237,143,380
1695,178,123,1,0,321,77,398,1223,349,1572
1761,178,67,0,0,366,0,366,91,0,91
2049,178,185,1,0,315,0,315,542,0,542
3178,178,166,0,0,265,487,752,403,916,1319
3704,178,274,1,2,39,416,455,173,860,1033
337,177,358,1,0,58,215,273,101,1765,1866
960,177,408,1,2,108,131,239,310,976,1286
1386,177,80,2,1,129,921,1050,147,149,296
1480,177,45,0,0,83,349,432,223,244,467
1591,177,112,2,1,296,568,864,340,102,442
1770,177,32,0,0,266,1092,1358,33,47,80
2837,177,8,0,0,13,305,318,61,69,130
4070,177,72,0,0,110,393,503,311,468,779
568,176,57,0,1,879,199,1078,158,32,190
898,176,90,0,0,282,253,535,463,592,1055
1610,176,39,0,1,371,336,707,206,170,376
2217,176,176,2,1,205,679,884,478,522,1000
2265,176,30,0,1,13,722,735,6,47,53
2305,176,141,0,2,21,390,411,52,381,433
2775,176,13,0,1,374,58,432,184,169,353
2890,176,19,0,1,543,7,550,22,0,22
3899,176,52,2,1,1313,547,1860,114,41,155
660,175,102,2,1,569,107,676,160,204,364
736,175,156,2,1,54,659,713,120,263,383
954,175,140,0,0,279,32,311,392,399,791
1204,175,79,0,0,222,496,718,89,66,155
1592,175,102,1,1,523,3,526,191,1532,1723
1673,175,128,0,0,428,146,574,248,464,712
2690,175,70,2,1,1118,523,1641,107,102,209
3165,175,24,0,0,1424,1091,2515,234,247,481
3655,175,353,1,1,264,7,271,818,826,1644
116,174,101,0,0,309,307,616,204,251,455
1252,174,91,1,0,203,143,346,1297,1328,2625
1287,174,287,1,0,120,137,257,355,1291,1646
2012,174,582,2,2,625,105,730,2065,186,2251
3206,174,42,2,1,52,983,1035,13,106,119
1414,173,247,1,0,114,320,434,45,672,717
2431,173,436,2,1,381,9,390,1407,1,1408
2641,173,41,0,0,204,450,654,52,67,119
3379,173,159,1,0,21,262,283,88,377,465
3817,173,22,0,0,42,372,414,31,58,89
3954,173,161,2,1,42,1089,1131,230,710,940
4038,173,102,1,2,545,19,564,168,28,196
688,172,104,1,0,278,0,278,196,0,196
707,172,162,2,1,291,69,360,448,20,468
757,172,20,0,1,212,360,572,33,29,62
1508,172,24,0,0,107,435,542,19,42,61
1725,172,174,2,1,738,628,1366,236,467,703
2070,172,390,1,2,217,153,370,168,1402,1570
2281,172,5,0,0,16,325,341,4,3,7
2957,172,232,1,0,73,232,305,227,927,1154
3610,172,126,0,0,485,142,627,540,613,1153
1343,171,111,0,0,316,277,593,349,460,809
1483,171,193,2,1,249,437,686,355,566,921
2380,171,52,0,1,503,96,599,606,531,1137
2493,171,9,0,1,849,1454,2303,47,33,80
2653,171,50,0,0,143,442,585,140,199,339
2685,171,50,0,0,21,454,475,80,174,254
2839,171,73,0,0,176,228,404,287,120,407
345,170,142,0,0,312,38,350,854,554,1408
1137,170,124,0,0,171,66,237,168,191,359
1425,170,136,0,0,237,74,311,568,640,1208
1841,170,125,2,1,406,607,1013,365,531,896
2778,170,290,1,0,26,226,252,139,1166,1305
3083,170,228,2,1,32,930,962,91,741,832
3477,170,60,0,0,0,452,452,190,362,552
372,169,246,2,0,539,875,1414,1026,132,1158
451,169,70,0,1,222,111,333,239,115,354
529,169,179,2,1,359,196,555,689,364,1053
537,169,171,0,0,360,91,451,821,455,1276
1050,169,82,0,1,206,310,516,484,590,1074
1105,169,132,1,2,33,377,410,23,257,280
1275,169,83,1,0,418,47,465,76,75,151
2730,169,88,1,1,242,21,263,1170,1794,2964
3364,169,204,2,1,1734,176,1910,1477,448,1925
3400,169,24,0,1,1434,952,2386,127,52,179
1772,168,16,0,0,570,560,1130,71,80,151
2205,168,63,2,1,40,564,604,64,95,159
2975,168,106,1,1,16,324,340,27,161,188
563,167,53,0,1,317,159,476,719,711,1430
983,167,80,0,0,30,352,382,18,129,147
1270,167,107,0,1,280,64,344,715,538,1253
1402,167,53,1,0,11,1098,1109,17,156,173
2453,167,15,0,1,156,694,850,33,29,62
2666,167,265,2,1,32,457,489,40,914,954
3328,167,57,0,0,235,742,977,100,47,147
294,166,120,2,1,566,348,914,862,459,1321
714,166,149,2,1,1247,481,1728,525,84,609
878,166,201,2,1,174,607,781,68,464,532
1367,166,223,1,0,172,49,221,94,689,783
2144,166,91,1,2,230,0,230,128,0,128
2581,166,34,0,0,332,512,844,24,61,85
2786,166,37,0,0,592,453,1045,187,219,406
3546,166,71,1,2,211,215,426,90,171,261
194,165,93,2,1,241,921,1162,268,127,395
2697,165,72,0,0,84,674,758,37,163,200
2821,165,169,0,0,86,343,429,143,326,469
3537,165,91,2,1,176,785,961,131,286,417
374,164,313,1,0,252,4,256,332,882,1214
1020,164,466,1,2,249,2,251,221,1844,2065
1303,164,101,0,1,396,166,562,639,910,1549
1619,164,47,0,0,378,393,771,112,120,232
2123,164,50,0,1,448,0,448,140,0,140
60,163,117,0,0,82,275,357,86,321,407
945,163,266,2,1,981,140,1121,1609,350,1959
1322,163,133,0,0,136,162,298,546,738,1284
1829,163,60,1,2,16,392,408,80,152,232
1953,163,30,0,0,234,59,293,34,24,58
2422,163,33,0,1,559,1014,1573,144,118,262
2656,163,181,2,1,474,310,784,291,279,570
3108,163,27,0,0,272,1441,1713,132,114,246
111,162,38,0,0,325,77,402,33,53,86
340,162,46,0,0,13,354,367,358,403,761
1027,162,90,0,0,182,56,238,39,179,218
1062,162,74,0,0,459,565,1024,390,526,916
1626,162,134,0,0,181,266,447,205,467,672
1932,162,50,0,0,619,0,619,85,0,85
2408,162,36,0,1,549,349,898,242,209,451
2973,162,25,0,1,24,652,676,71,130,201
3701,162,13,1,2,496,0,496,18,0,18
449,161,156,2,1,296,717,1013,327,395,722
681,161,122,2,1,2436,570,3006,653,90,743
1320,161,55,0,1,397,621,1018,142,144,286
1935,161,24,2,1,57,534,591,53,3,56
2841,161,10,0,1,503,1,504,20,2,22
3176,161,53,0,0,456,141,597,1831,1627,3458
3525,161,33,0,0,11,418,429,13,71,84
249,160,105,0,0,232,166,398,565,662,1227
275,160,171,1,0,229,50,279,371,40,411
504,160,39,0,1,263,633,896,129,53,182
805,160,421,1,2,129,121,250,69,1412,1481
947,160,60,0,0,208,124,332,134,75,209
1898,160,191,2,1,1113,2,1115,1222,302,1524
2103,160,20,0,1,604,393,997,37,18,55
2643,160,96,2,1,563,224,787,761,563,1324
4014,160,145,2,1,299,578,877,517,530,1047
478,159,251,1,2,597,373,970,211,577,788
1198,159,37,0,1,207,470,677,66,75,141
1735,159,15,0,0,542,283,825,132,119,251
1999,159,62,2,1,228,353,581,137,12,149
2245,159,127,0,0,217,297,514,375,776,1151
3136,159,9,0,1,789,6,795,12,0,12
3303,159,16,0,0,50,514,564,16,31,47
602,158,346,1,1,4,262,266,78,1564,1642
702,158,125,2,1,302,562,864,248,483,731
1110,158,48,0,1,2077,891,2968,123,107,230
1219,158,184,0,0,214,81,295,492,873,1365
1365,158,203,2,1,155,590,745,199,849,1048
2472,158,38,0,0,273,452,725,124,160,284
2539,158,15,0,1,383,10,393,90,9,99
2612,158,67,2,1,86,405,491,70,89,159
83,157,52,0,0,22,327,349,108,180,288
285,157,40,0,0,27,367,394,127,185,312
625,157,168,0,0,228,49,277,1224,738,1962
672,157,250,1,0,188,69,257,1581,456,2037
825,157,75,0,0,249,228,477,61,141,202
1289,157,16,0,1,201,117,318,229,211,440
2279,157,104,1,1,201,0,201,196,0,196
3051,157,62,0,1,81,424,505,101,134,235
3144,157,51,0,0,133,308,441,274,289,563
549,156,13,0,1,351,1083,1434,49,52,101
1117,156,228,0,0,179,149,328,913,605,1518
1745,156,238,2,1,21,464,485,60,938,998
2314,156,156,2,1,184,451,635,410,461,871
2809,156,70,0,1,190,215,405,228,119,347
2987,156,96,0,0,207,217,424,450,630,1080
3031,156,5,0,0,17,540,557,31,32,63
3297,156,213,2,1,260,284,544,250,753,1003
3388,156,108,0,0,340,109,449,951,839,1790
3489,156,81,0,0,102,236,338,194,300,494
3594,156,53,0,0,83,863,946,18,87,105
3612,156,12,0,1,4,461,465,13,26,39
459,155,28,0,0,2436,0,2436,174,0,174
1229,155,19,0,0,74,870,944,22,36,58
1792,155,100,0,0,48,344,392,222,701,923
2396,155,54,2,1,311,504,815,86,72,158
2414,155,95,2,1,606,195,801,213,194,407
2512,155,36,0,0,68,438,506,104,185,289
2646,155,416,1,2,89,152,241,78,1436,1514
2700,155,29,0,0,41,374,415,31,59,90
3301,155,36,0,0,1156,892,2048,66,73,139
3848,155,17,0,0,439,63,502,69,50,119
3882,155,43,0,1,933,263,1196,167,127,294
493,154,209,2,1,406,191,597,422,632,1054
1789,154,7,0,0,142,1086,1228,10,8,18
2001,154,77,2,1,87,529,616,126,203,329
2107,154,96,1,1,1,275,276,10,347,357
2518,154,10,0,1,420,3,423,14,3,17
3966,154,70,0,1,317,444,761,248,197,445
191,153,21,0,0,64,437,501,22,85,107
1249,153,100,0,0,175,346,521,580,759,1339
1747,153,258,0,0,296,7,303,472,678,1150
1748,153,107,2,1,206,299,505,279,245,524
3247,153,87,2,1,137,917,1054,50,173,223
3780,153,159,2,1,140,442,582,401,541,942
3894,153,56,0,0,47,416,463,33,115,148
182,152,106,2,1,891,376,1267,741,164,905
383,152,12,0,0,41,426,467,14,11,25
439,152,66,0,1,237,329,566,341,358,699
454,152,72,1,0,2,491,493,10,137,147
1055,152,24,0,0,276,91,367,34,15,49
1093,152,78,0,0,518,200,718,214,350,564
2051,152,97,2,1,874,225,1099,354,75,429
2446,152,223,2,1,95,429,524,106,601,707
3018,152,28,0,0,100,797,897,52,52,104
3088,152,16,0,1,71,290,361,54,56,110
3154,152,47,0,1,457,386,843,189,130,319
3245,152,203,0,0,5,377,382,232,770,1002
3624,152,145,2,1,98,581,679,225,743,968
1112,151,135,0,0,127,245,372,437,494,931
1391,151,106,2,1,1029,782,1811,167,146,313
1613,151,24,0,0,40,443,483,31,79,110
2553,151,30,0,1,63,466,529,82,128,210
2922,151,36,1,2,374,92,466,57,2,59
3908,151,20,0,0,70,344,414,18,43,61
596,150,233,2,1,67,374,441,137,653,790
718,150,8,0,1,256,0,256,9,0,9
1125,150,44,0,1,430,27,457,157,84,241
1694,150,48,2,1,135,335,470,90,1,91
1916,150,20,0,0,25,635,660,3,38,41
1988,150,60,2,1,218,909,1127,104,164,268
2059,150,45,2,1,481,593,1074,358,312,670
2124,150,99,0,0,129,380,509,139,638,777
833,149,64,0,0,54,225,279,125,182,307
1625,149,71,0,1,733,920,1653,129,188,317
1766,149,127,0,0,219,45,264,425,468,893
1835,149,75,0,0,45,212,257,158,210,368
3071,149,132,2,1,29,639,668,99,721,820
3113,149,152,1,2,762,0,762,585,0,585
3270,149,20,0,1,331,58,389,118,90,208
3342,149,117,0,0,38,320,358,166,434,600
161,148,54,0,0,138,326,464,170,217,387
394,148,332,1,0,21,226,247,108,1283,1391
1194,148,151,0,0,191,495,686,109,458,567
1514,148,29,0,0,261,36,297,714,703,1417
1615,148,136,1,0,361,0,361,256,0,256
1759,148,20,0,0,795,1203,1998,32,30,62
2023,148,50,0,0,1260,754,2014,152,109,261
2866,148,74,2,1,448,71,519,249,29,278
3361,148,46,0,1,125,377,502,227,316,543
3638,148,148,0,0,278,15,293,211,175,386
3997,148,38,0,1,325,462,787,120,154,274
765,147,20,0,0,1,203,204,14,33,47
1098,147,36,0,0,40,524,564,24,79,103
1325,147,96,2,1,1589,910,2499,676,158,834
1430,147,35,0,1,131,1058,1189,213,273,486
2541,147,95,2,1,364,685,1049,337,202,539
3093,147,96,0,0,149,193,342,759,700,1459
3308,147,141,1,1,30,218,248,166,492,658
3604,147,22,0,1,223,910,1133,48,73,121
3629,147,66,0,0,381,0,381,159,0,159
3793,147,52,0,0,108,468,576,38,85,123
500,146,54,0,0,207,306,513,82,118,200
839,146,137,2,2,801,312,1113,203,7,210
1991,146,59,0,1,287,15,302,346,249,595
2330,146,17,0,0,26,351,377,11,31,42
130,145,22,0,1,63,345,408,204,203,407
200,145,40,1,0,318,16,334,58,80,138
1490,145,41,0,1,229,24,253,90,58,148
1587,145,55,1,0,178,445,623,63,54,117
2676,145,76,0,0,139,324,463,234,434,668
2889,145,99,0,1,119,721,840,134,429,563
3956,145,25,0,1,124,363,487,33,7,40
519,144,9,0,1,324,0,324,9,0,9
542,144,15,0,1,118,426,544,241,242,483
909,144,37,0,0,555,163,718,72,4,76
1008,144,64,0,1,249,378,627,288,349,637
1169,144,52,2,1,348,177,525,212,152,364
2091,144,12,0,0,8,433,441,1,11,12
2285,144,254,1,1,57,234,291,46,1011,1057
2411,144,5,0,1,754,1252,2006,38,33,71
3003,144,83,0,1,185,154,339,324,407,731
3012,144,86,2,1,1097,1269,2366,274,454,728
3041,144,19,0,1,414,1228,1642,82,95,177
3132,144,104,1,2,250,44,294,147,31,178
433,143,158,2,1,201,355,556,326,349,675
458,143,20,2,1,39,2033,2072,9,29,38
614,143,113,1,2,520,0,520,328,0,328
1875,143,20,0,0,85,731,816,18,40,58
2066,143,62,0,1,362,82,444,231,238,469
2538,143,33,2,1,23,1398,1421,36,65,101
2823,143,84,1,2,204,308,512,162,212,374
3021,143,92,2,1,300,390,690,175,282,457
3182,143,65,0,1,168,100,268,300,154,454
3913,143,249,0,0,258,10,268,1657,447,2104
666,142,189,1,0,26,224,250,517,947,1464
1416,142,65,0,0,373,312,685,277,225,502
1656,142,50,0,0,38,431,469,211,294,505
1867,142,91,0,0,258,294,552,44,151,195
1970,142,52,0,0,256,270,526,172,153,325
2290,142,24,0,0,151,412,563,97,91,188
2395,142,135,0,0,86,268,354,313,465,778
4063,142,345,1,2,128,111,239,212,841,1053
2055,141,27,0,0,147,369,516,148,201,349
2194,141,47,0,1,1151,550,1701,144,103,247
2687,141,16,0,0,0,338,338,0,24,24
3170,141,61,0,1,253,171,424,173,93,266
3194,141,37,0,0,235,0,235,78,0,78
73,140,59,0,0,214,18,232,146,108,254
902,140,73,0,1,259,0,259,142,0,142
1009,140,96,0,0,81,220,301,549,563,1112
1011,140,100,0,1,77,254,331,738,902,1640
1191,140,59,0,0,161,535,696,203,364,567
1376,140,341,1,2,171,7,178,577,619,1196
1485,140,12,0,1,61,486,547,165,174,339
1530,140,230,2,1,190,159,349,221,775,996
1892,140,4,0,1,1,687,688,3,10,13
1977,140,13,0,0,125,372,497,144,135,279
2489,140,22,0,0,7,250,257,184,222,406
2784,140,100,0,0,142,163,305,232,123,355
3172,140,27,0,1,225,329,554,135,110,245
3348,140,26,0,0,86,727,813,36,70,106
3833,140,206,2,1,86,505,591,82,395,477
4069,140,38,0,0,139,548,687,77,73,150
801,139,6,0,0,31,513,544,12,16,28
1259,139,49,0,1,122,164,286,235,300,535
1699,139,301,1,2,183,84,267,790,1167,1957
1705,139,19,0,1,444,35,479,22,3,25
1951,139,79,2,1,261,267,528,76,138,214
3196,139,204,1,0,14,250,264,99,623,722
491,138,59,0,1,283,91,374,999,885,1884
1920,138,336,2,1,249,230,479,159,1466,1625
2105,138,40,0,0,21,310,331,35,120,155
2289,138,46,0,1,110,150,260,164,316,480
2439,138,72,2,1,157,306,463,444,266,710
2560,138,48,0,1,287,84,371,43,29,72
3559,138,78,0,1,137,200,337,480,324,804
4056,138,33,0,1,188,243,431,80,48,128
619,137,69,0,1,187,357,544,625,558,1183
2102,137,134,2,1,149,636,785,196,326,522
2741,137,224,2,1,245,284,529,764,331,1095
3137,137,268,2,1,38,337,375,68,1077,1145
3349,137,83,1,0,156,114,270,331,404,735
3385,137,59,0,1,346,411,757,297,331,628
4028,137,224,2,1,424,6,430,398,1,399
331,136,98,2,1,247,517,764,278,115,393
745,136,48,0,0,586,16,602,66,84,150
962,136,45,0,0,197,204,401,334,396,730
1360,136,23,0,0,55,212,267,8,23,31
1806,136,88,0,0,158,275,433,44,148,192
2304,136,52,0,1,171,261,432,153,206,359
2438,136,99,2,1,47,629,676,89,348,437
2469,136,85,2,1,270,1383,1653,165,369,534
1936,135,37,0,1,117,254,371,130,49,179
2603,135,44,0,0,149,608,757,290,94,384
2732,135,82,0,1,222,69,291,212,41,253
2974,135,42,0,1,96,462,558,271,330,601
669,134,78,0,1,414,153,567,861,886,1747
725,134,102,2,1,326,793,1119,302,426,728
740,134,33,0,0,133,69,202,124,159,283
904,134,56,0,0,3,437,440,23,123,146
1551,134,76,1,0,105,163,268,81,215,296
1937,134,14,0,1,99,552,651,85,100,185
2561,134,34,0,1,231,662,893,93,130,223
2783,134,14,2,1,7,1377,1384,12,76,88
3073,134,32,0,0,325,182,507,88,17,105
3564,134,15,0,0,6,366,372,5,40,45
3782,134,145,0,0,6,259,265,30,293,323
3917,134,285,1,2,8,293,301,58,1030,1088
64,133,47,1,2,170,0,170,55,0,55
1159,133,98,1,0,208,0,208,178,0,178
1327,133,123,2,1,240,4,244,523,191,714
1750,133,26,0,0,949,594,1543,344,289,633
1869,133,7,0,0,3,404,407,2,10,12
2457,133,41,2,1,1936,1384,3320,93,33,126
2683,133,150,2,1,145,395,540,178,426,604
3185,133,45,0,1,808,973,1781,175,81,256
3280,133,60,1,2,198,0,198,82,0,82
3357,133,72,0,1,239,81,320,598,476,1074
3370,133,85,0,0,165,401,566,106,315,421
3936,133,17,0,1,153,119,272,740,739,1479
224,132,123,1,2,92,144,236,50,191,241
316,132,81,2,1,270,508,778,399,667,1066
341,132,191,2,1,733,254,987,410,240,650
479,132,182,2,0,822,47,869,1495,333,1828
1392,132,4,0,2,150,207,357,56,54,110
1862,132,57,0,1,196,153,349,164,172,336
2738,132,93,0,1,12,502,514,113,391,504
3276,132,34,0,1,280,0,280,47,0,47
3416,132,407,1,2,57,154,211,50,1105,1155
3661,132,341,1,2,47,166,213,117,960,1077
656,131,19,0,0,72,481,553,20,24,44
1195,131,87,2,1,665,748,1413,156,131,287
1227,131,99,1,0,127,308,435,125,55,180
1256,131,46,0,0,143,396,539,274,346,620
1505,131,171,2,1,689,1953,2642,390,71,461
1604,131,296,2,1,68,298,366,80,893,973
3055,131,47,2,1,141,1176,1317,39,106,145
3652,131,24,0,0,11,314,325,31,70,101
3837,131,70,1,0,185,0,185,243,0,243
3851,131,271,1,0,11,172,183,40,1696,1736
1405,130,32,0,1,158,41,199,142,113,255
1775,130,62,0,0,14,322,336,35,139,174
1872,130,37,0,0,251,53,304,61,96,157
3189,130,9,0,0,354,144,498,80,68,148
3584,130,78,1,2,187,0,187,117,0,117
99,129,17,0,0,724,1589,2313,5,16,21
1477,129,142,0,0,267,160,427,397,213,610
1548,129,19,0,0,664,1648,2312,16,28,44
1571,129,17,2,1,10,528,538,87,67,154
1597,129,62,2,1,115,478,593,173,222,395
1909,129,57,0,0,151,474,625,29,92,121
2564,129,29,0,1,34,561,595,30,86,116
3010,129,5,0,0,57,384,441,1,4,5
3140,129,26,0,0,255,1264,1519,41,17,58
3402,129,101,0,1,361,304,665,580,632,1212
3571,129,49,0,1,515,769,1284,75,191,266
3949,129,60,0,0,40,390,430,300,511,811
45,128,64,0,0,14,249,263,6,95,101
52,128,16,0,0,527,290,817,38,33,71
358,128,58,2,1,610,287,897,181,61,242
422,128,134,2,1,56,341,397,109,272,381
1311,128,29,0,1,605,414,1019,50,55,105
1474,128,31,2,1,12,474,486,57,66,123
2357,128,205,1,0,27,286,313,308,878,1186
2462,128,25,0,1,644,477,1121,151,160,311
2808,128,30,0,0,284,344,628,51,75,126
3274,128,25,0,0,238,192,430,55,66,121
3293,128,70,2,1,193,574,767,110,172,282
3356,128,168,2,1,6,427,433,41,881,922
3972,128,10,0,1,211,241,452,194,201,395
205,127,10,0,0,986,277,1263,20,10,30
438,127,245,2,1,394,427,821,366,1012,1378
1201,127,47,0,0,173,191,364,90,94,184
1706,127,48,0,1,734,536,1270,288,207,495
2129,127,176,2,1,318,681,999,313,401,714
2647,127,83,0,0,191,940,1131,52,170,222
2724,127,27,0,1,305,16,321,249,220,469
2729,127,29,0,0,9,362,371,12,51,63
3415,127,30,0,0,185,406,591,24,59,83
3669,127,103,2,1,241,345,586,183,240,423
3814,127,110,0,1,334,147,481,349,440,789
3843,127,23,0,0,332,371,703,17,35,52
3977,127,24,0,1,700,613,1313,62,29,91
726,126,119,0,0,182,58,240,732,668,1400
1298,126,194,0,0,82,103,185,363,647,1010
2097,126,59,2,1,309,337,646,584,630,1214
2167,126,35,0,1,65,500,565,16,52,68
3799,126,73,2,2,105,752,857,64,293,357
3859,126,19,0,0,79,672,751,85,114,199
3996,126,43,0,1,400,0,400,110,0,110
1054,125,378,1,0,37,170,207,47,1801,1848
1321,125,40,0,0,88,296,384,43,67,110
1361,125,15,0,0,42,270,312,3,15,18
1487,125,171,2,0,348,609,957,370,436,806
1670,125,7,0,1,194,560,754,174,176,350
1901,125,81,0,0,169,213,382,211,395,606
1929,125,113,0,0,3,352,355,11,188,199
2074,125,31,2,1,114,277,391,46,10,56
2104,125,57,0,1,37,317,354,223,266,489
2437,125,100,1,2,22,350,372,43,266,309
3197,125,43,2,0,54,403,457,224,182,406
3305,125,463,1,0,56,121,177,56,1817,1873
3596,125,35,1,0,36,162,198,168,199,367
330,124,132,2,1,530,0,530,781,0,781
1341,124,86,0,0,242,333,575,447,449,896
1824,124,35,0,0,47,230,277,342,381,723
1954,124,36,0,0,58,479,537,33,95,128
1985,124,30,2,1,62,248,310,33,19,52
2399,124,136,0,1,196,130,326,594,691,1285
2972,124,54,2,1,1,527,528,15,97,112
3130,124,94,2,1,440,7,447,194,23,217
3512,124,56,0,0,19,432,451,133,315,448
3521,124,5,0,1,236,245,481,383,379,762
3765,124,365,0,0,39,158,197,196,1266,1462
3969,124,8,0,0,43,394,437,17,18,35
973,123,33,0,1,241,0,241,47,0,47
1450,123,9,0,1,220,124,344,424,417,841
2830,123,17,0,1,117,271,388,24,35,59
3091,123,80,0,1,303,115,418,631,824,1455
3224,123,43,0,1,203,0,203,112,51,163
3641,123,10,0,1,292,198,490,110,116,226
65,122,288,2,1,506,81,587,521,908,1429
940,122,49,1,0,200,0,200,84,0,84
1091,122,18,0,0,10,321,331,21,25,46
1563,122,317,2,1,84,243,327,124,767,891
1634,122,71,1,1,290,108,398,64,1099,1163
1663,122,100,0,0,195,155,350,532,660,1192
2638,122,20,0,1,278,209,487,96,16,112
2887,122,375,1,2,78,112,190,245,1392,1637
3649,122,71,0,0,202,0,202,155,0,155
2434,121,45,0,1,41,498,539,30,134,164
2615,121,55,0,0,88,164,252,446,298,744
790,120,61,2,1,331,71,402,183,144,327
2155,120,20,0,0,517,433,950,376,368,744
2617,120,59,2,1,420,0,420,135,0,135
2626,120,68,0,1,412,415,827,1167,1233,2400
2856,120,11,0,1,12,464,476,6,19,25
2878,120,75,1,0,11,182,193,11,131,142
3023,120,17,0,0,9,281,290,252,292,544
3404,120,49,0,1,263,150,413,349,347,696
654,119,52,2,1,306,209,515,116,35,151
963,119,10,0,0,294,0,294,15,0,15
1541,119,34,0,1,749,622,1371,628,642,1270
1995,119,84,2,1,332,212,544,310,124,434
2796,119,20,0,1,181,16,197,212,186,398
3114,119,19,0,0,51,324,375,75,108,183
3148,119,52,0,1,208,249,457,643,577,1220
3989,119,20,0,0,721,94,815,156,127,283
140,118,131,2,1,295,166,461,329,427,756
390,118,2,0,2,299,0,299,2,0,2
1069,118,265,1,0,185,15,200,515,37,552
1123,118,45,0,1,233,44,277,416,387,803
1434,118,52,2,1,131,180,311,467,441,908
1598,118,44,0,0,117,291,408,311,257,568
2256,118,66,0,1,242,18,260,375,313,688
2421,118,88,2,1,30,302,332,58,297,355
2601,118,12,0,1,406,28,434,140,129,269
3562,118,21,0,1,72,360,432,154,190,344
4060,118,115,0,0,79,183,262,473,538,1011
850,117,140,0,0,60,224,284,246,616,862
869,117,56,0,2,861,299,1160,212,145,357
1318,117,178,0,0,27,278,305,51,591,642
1678,117,143,1,0,69,133,202,653,588,1241
2629,117,244,2,1,246,289,535,562,244,806
3259,117,235,0,0,7,186,193,66,666,732
3352,117,39,2,1,424,6,430,66,2,68
3871,117,156,2,1,327,223,550,273,293,566
3934,117,56,0,0,16,334,350,9,129,138
4059,117,18,0,1,37,362,399,101,97,198
412,116,131,0,0,208,55,263,614,353,967
523,116,125,2,1,593,44,637,901,340,1241
803,116,101,1,1,132,33,165,31,326,357
1197,116,66,0,0,170,102,272,44,78,122
1519,116,7,0,1,85,460,545,153,153,306
1578,116,16,0,0,473,52,525,138,119,257
1733,116,51,0,0,31,339,370,18,177,195
2158,116,17,0,0,131,197,328,52,38,90
2845,116,40,0,1,88,301,389,124,157,281
2908,116,12,0,1,101,94,195,25,13,38
3742,116,2,2,1,5,576,581,2,4,6
488,115,97,2,1,548,31,579,1835,1797,3632
851,115,56,0,0,75,198,273,49,80,129
1003,115,38,0,1,354,376,730,56,276,332
1283,115,23,0,0,371,497,868,143,126,269
1586,115,49,0,0,163,106,269,130,76,206
1602,115,20,0,0,80,974,1054,34,13,47
2424,115,126,2,1,641,453,1094,445,59,504
2486,115,16,0,0,219,332,551,93,94,187
2516,115,54,0,0,129,205,334,218,246,464
2669,115,59,0,1,216,352,568,455,669,1124
3150,115,88,2,1,450,304,754,344,177,521
3334,115,94,0,1,80,266,346,275,446,721
3633,115,163,1,2,217,148,365,1137,1198,2335
3860,115,30,0,0,4,363,367,21,67,88
1539,114,231,2,1,128,111,239,173,532,705
1832,114,26,0,1,272,68,340,205,179,384
1940,114,19,0,1,151,322,473,51,123,174
2274,114,98,2,1,486,0,486,356,0,356
2313,114,12,0,1,622,339,961,36,24,60
2831,114,54,2,1,91,698,789,116,312,428
3169,114,6,0,1,57,484,541,59,68,127
3248,114,32,0,0,10,319,329,89,144,233
3435,114,36,0,0,197,235,432,292,299,591
3438,114,11,0,1,45,277,322,10,16,26
3482,114,61,1,0,60,157,217,16,72,88
4029,114,33,0,0,109,387,496,72,145,217
650,113,125,2,1,169,190,359,650,278,928
1001,113,27,0,0,6,519,525,2,43,45
1377,113,39,0,1,205,199,404,279,287,566
2317,113,65,2,1,392,238,630,106,232,338
3441,113,68,0,1,721,375,1096,348,251,599
189,112,137,2,1,707,11,718,242,197,439
342,112,54,1,2,339,8,347,158,1,159
777,112,22,0,0,708,728,1436,340,328,668
1707,112,261,2,1,380,148,528,736,1150,1886
2221,112,18,0,1,294,721,1015,58,80,138
2745,112,157,0,0,16,144,160,160,624,784
2851,112,37,0,1,250,121,371,100,26,126
3712,112,42,0,0,8,163,171,245,312,557
1448,111,46,2,1,468,184,652,90,47,137
2225,111,8,0,1,45,306,351,20,15,35
2498,111,15,0,1,282,51,333,30,6,36
2597,111,68,0,1,228,260,488,931,734,1665
2651,111,15,2,1,446,756,1202,29,5,34
3607,111,197,1,1,9,172,181,122,522,644
3626,111,155,1,2,5,154,159,52,360,412
3827,111,25,0,1,100,283,383,165,199,364
616,110,51,2,1,185,68,253,132,30,162
1306,110,129,2,1,503,220,723,162,435,597
1826,110,6,0,2,18,342,360,36,38,74
1833,110,70,2,1,95,297,392,108,120,228
1874,110,64,0,0,67,226,293,74,191,265
2239,110,36,0,1,295,105,400,223,207,430
2567,110,27,0,0,2,226,228,12,65,77
3026,110,39,0,1,270,88,358,279,311,590
3064,110,71,0,1,127,426,553,747,950,1697
3264,110,269,1,0,4,227,231,79,732,811
3326,110,4,0,0,69,411,480,29,33,62
3698,110,25,0,1,243,58,301,766,701,1467
4006,110,63,2,1,482,425,907,475,553,1028
86,109,51,0,0,21,246,267,37,348,385
773,109,213,2,1,15,647,662,11,1298,1309
944,109,62,0,0,202,42,244,688,649,1337
1221,109,45,0,1,17,228,245,235,529,764
1644,109,39,0,1,203,237,440,237,251,488
1753,109,32,0,1,21,264,285,59,110,169
1773,109,199,2,1,19,228,247,48,1367,1415
1919,109,23,0,0,85,198,283,39,60,99
2018,109,150,1,0,135,0,135,435,154,589
2257,109,62,0,0,42,338,380,62,162,224
3734,109,45,0,1,285,217,502,238,230,468
3751,109,15,0,0,50,228,278,85,107,192
2,108,36,0,0,63,103,166,37,76,113
1396,108,33,0,0,2,165,167,1,40,41
1687,108,73,0,0,193,0,193,137,0,137
2061,108,59,0,1,73,337,410,41,46,87
2375,108,315,1,2,15,120,135,231,979,1210
2393,108,40,0,0,90,362,452,397,389,786
2483,108,49,0,1,103,70,173,70,123,193
2506,108,53,0,1,325,313,638,461,435,896
2639,108,56,2,1,314,107,421,232,247,479
2815,108,43,0,1,7,528,535,228,304,532
3008,108,26,2,1,214,184,398,45,17,62
3173,108,6,0,0,62,394,456,12,17,29
3234,108,38,0,1,224,550,774,178,447,625
381,107,139,0,0,276,166,442,572,708,1280
470,107,25,2,1,111,345,456,35,28,63
886,107,64,2,1,372,0,372,95,0,95
948,107,186,1,0,51,147,198,345,852,1197
1224,107,20,0,1,146,199,345,43,96,139
1288,107,130,0,0,86,115,201,190,455,645
1784,107,19,0,1,166,171,337,390,390,780
2599,107,63,0,1,66,544,610,216,319,535
2654,107,6,0,1,230,335,565,12,12,24
2997,107,8,0,1,181,81,262,21,19,40
3043,107,176,2,1,309,590,899,438,1157,1595
3395,107,32,0,1,292,57,349,98,46,144
3587,107,81,0,0,93,118,211,538,703,1241
3740,107,32,0,0,57,289,346,187,265,452
3845,107,10,0,0,179,599,778,11,17,28
4043,107,45,2,1,18,333,351,94,202,296
230,106,106,2,1,630,657,1287,210,89,299
806,106,10,0,1,17,316,333,25,34,59
890,106,54,2,1,35,638,673,123,231,354
1100,106,12,0,0,17,200,217,14,25,39
1203,106,143,1,2,82,72,154,401,550,951
1211,106,76,0,0,173,134,307,251,434,685
1570,106,81,0,1,93,172,265,349,474,823
2036,106,25,0,1,249,0,249,33,0,33
2338,106,63,0,0,178,337,515,209,353,562
2441,106,23,0,0,49,298,347,25,48,73
2742,106,67,0,1,270,62,332,823,821,1644
2913,106,10,1,0,136,311,447,78,73,151
3448,106,22,1,2,1785,1657,3442,27,0,27
3815,106,17,0,0,99,333,432,80,66,146
4050,106,10,0,0,10,215,225,78,87,165
147,105,96,0,0,117,313,430,76,330,406
584,105,30,0,0,116,708,824,17,56,73
626,105,36,1,0,208,0,208,55,0,55
1047,105,27,0,0,60,237,297,50,67,117
1202,105,24,0,0,246,395,641,73,83,156
1837,105,253,2,1,410,510,920,86,909,995
2017,105,103,1,0,15,155,170,92,101,193
2635,105,13,0,0,55,395,450,2,15,17
2640,105,11,0,1,490,605,1095,18,2,20
2746,105,1,0,1,0,222,222,151,152,303
3275,105,109,2,1,307,163,470,310,272,582
3684,105,324,2,1,103,209,312,222,1005,1227
3852,105,24,0,0,91,323,414,45,70,115
447,104,15,0,1,0,350,350,65,75,140
1359,104,63,0,0,21,131,152,211,334,545
1599,104,9,0,0,6,178,184,42,50,92
1734,104,35,1,0,128,0,128,47,0,47
1978,104,58,2,1,671,390,1061,105,123,228
2394,104,60,0,1,145,6,151,136,263,399
2423,104,80,2,1,155,523,678,98,374,472
2461,104,17,0,1,4,342,346,17,38,55
3298,104,39,2,1,152,251,403,159,110,269
3842,104,21,0,1,56,618,674,62,96,158
105,103,41,1,0,150,0,150,50,0,50
611,103,122,0,0,5,200,205,49,302,351
900,103,104,2,1,619,442,1061,623,519,1142
2278,103,252,2,1,110,101,211,190,623,813
2283,103,51,1,1,322,238,560,299,333,632
2614,103,11,0,0,4,269,273,1,13,14
2748,103,217,1,0,13,212,225,111,746,857
2824,103,13,0,1,197,6,203,36,19,55
3204,103,5,0,1,216,48,264,152,147,299
3380,103,1,0,0,12,167,179,14,15,29
3428,103,90,0,1,386,507,893,22,266,288
3702,103,50,0,1,128,36,164,117,56,173
897,102,145,0,0,150,43,193,698,407,1105
1501,102,67,0,0,69,132,201,56,162,218
1781,102,22,2,1,357,169,526,224,209,433
2139,102,20,2,1,409,918,1327,103,81,184
3289,102,23,0,0,42,569,611,32,79,111
3528,102,103,2,1,668,0,668,721,484,1205
3944,102,33,0,0,44,179,223,236,262,498
4011,102,25,0,1,112,233,345,278,267,545
903,101,37,0,1,612,111,723,418,375,793
1825,101,143,2,1,601,0,601,973,0,973
2467,101,8,2,1,74,343,417,6,4,10
2968,101,69,0,1,509,157,666,997,1100,2097
3421,101,3,0,1,107,138,245,11,10,21
410,100,109,2,1,349,1222,1571,166,0,166
567,100,15,0,0,103,1338,1441,87,94,181
628,100,41,0,1,196,33,229,172,196,368
682,100,88,2,2,156,2,158,170,2,172
715,100,131,0,1,426,102,528,565,132,697
1019,100,90,2,1,163,192,355,223,11,234
1397,100,91,0,0,112,79,191,175,395,570
1482,100,15,0,1,209,838,1047,115,85,200
1720,100,55,2,1,444,42,486,218,123,341
1907,100,10,0,0,857,614,1471,389,372,761
2229,100,38,0,0,269,253,522,77,101,178
2633,100,5,0,0,136,313,449,20,26,46
2777,100,42,0,1,335,0,335,163,0,163
2986,100,295,1,0,1,164,165,16,1117,1133
2993,100,165,0,0,81,483,564,274,751,1025
3784,100,144,2,1,36,276,312,93,702,795
3841,100,220,2,1,350,8,358,339,373,712
3885,100,33,1,2,146,0,146,79,0,79
3924,100,170,1,2,3,146,149,14,358,372
351,99,105,2,1,617,517,1134,636,357,993
593,99,42,0,1,230,104,334,373,311,684
663,99,93,0,0,174,0,174,257,0,257
734,99,17,0,1,267,203,470,78,60,138
949,99,261,2,2,682,512,1194,878,213,1091
1512,99,68,2,1,62,507,569,76,227,303
1655,99,18,2,1,8,308,316,1,22,23
2573,99,212,2,1,27,466,493,26,1029,1055
2678,99,27,0,0,58,678,736,82,113,195
2755,99,27,0,1,115,178,293,111,144,255
2782,99,99,0,0,187,295,482,66,258,324
2802,99,53,0,1,614,286,900,206,248,454
2929,99,10,0,0,67,542,609,21,29,50
3040,99,19,0,1,246,486,732,86,110,196
3070,99,68,2,1,355,868,1223,90,139,229
3125,99,33,2,1,91,348,439,59,92,151
3214,99,24,2,1,196,660,856,135,124,259
3322,99,23,0,0,221,95,316,52,28,80
245,98,30,1,0,148,185,333,30,28,58
543,98,35,0,1,179,158,337,287,225,512
560,98,91,1,1,85,374,459,61,150,211
710,98,5,0,0,64,271,335,5,6,11
941,98,31,0,0,239,219,458,123,121,244
1184,98,37,0,0,46,193,239,203,187,390
1527,98,23,0,1,649,560,1209,74,90,164
1624,98,218,2,1,5,235,240,38,802,840
1986,98,17,0,0,622,208,830,78,53,131
2201,98,16,2,1,218,330,548,327,317,644
2667,98,18,0,0,1137,313,1450,690,673,1363
2717,98,11,0,1,102,179,281,14,0,14
2977,98,58,0,1,122,219,341,385,404,789
3341,98,40,0,0,259,266,525,13,40,53
3783,98,38,0,0,304,55,359,25,52,77
3818,98,45,0,1,113,174,287,283,457,740
3992,98,50,0,1,186,127,313,326,311,637
668,97,11,0,1,0,167,167,8,21,29
1557,97,109,2,1,44,223,267,72,238,310
1840,97,33,0,1,150,457,607,106,178,284
1849,97,99,0,0,106,120,226,326,469,795
1987,97,35,0,0,101,268,369,83,149,232
2003,97,14,0,1,169,131,300,518,520,1038
3092,97,29,0,0,134,0,134,38,0,38
3953,97,21,0,0,50,553,603,25,123,148
215,96,373,1,0,154,16,170,1912,87,1999
782,96,98,2,1,244,200,444,198,217,415
970,96,28,0,0,139,11,150,386,365,751
1133,96,302,2,1,67,113,180,127,946,1073
1160,96,25,0,0,32,201,233,451,468,919
1823,96,24,0,1,469,478,947,99,77,176
2019,96,182,2,1,246,50,296,288,853,1141
2765,96,8,0,0,146,521,667,46,65,111
2967,96,27,0,1,175,348,523,192,183,375
3044,96,41,0,1,49,194,243,44,104,148
3246,96,110,0,0,161,106,267,638,621,1259
3323,96,12,0,0,42,277,319,46,59,105
3408,96,26,2,1,1,389,390,12,53,65
3529,96,88,2,1,201,229,430,113,136,249
3890,96,76,0,1,73,356,429,43,259,302
959,95,28,0,0,44,300,344,97,102,199
1104,95,37,0,1,184,8,192,108,47,155
1882,95,8,0,1,286,66,352,22,11,33
2273,95,38,2,1,30,522,552,86,236,322
2492,95,15,0,1,551,703,1254,13,25,38
2691,95,208,2,1,31,184,215,115,687,802
3046,95,13,0,1,15,192,207,177,186,363
3104,95,20,0,0,32,324,356,5,41,46
3586,95,26,0,1,76,413,489,53,104,157
3809,95,31,0,0,60,331,391,13,37,50
3995,95,38,2,1,184,220,404,336,325,661
218,94,74,1,0,1,142,143,19,159,178
1755,94,30,0,1,132,185,317,427,461,888
2181,94,15,0,0,151,499,650,34,59,93
2596,94,39,0,1,109,192,301,150,130,280
2699,94,12,0,1,8,192,200,188,215,403
2747,94,9,0,0,66,218,284,69,69,138
3720,94,23,0,0,28,413,441,55,105,160
3779,94,12,2,1,21,251,272,11,22,33
554,93,97,2,1,130,179,309,226,123,349
674,93,46,2,1,170,116,286,63,56,119
764,93,13,0,0,83,185,268,24,19,43
1023,93,44,0,0,13,154,167,201,304,505
1342,93,23,0,0,35,148,183,100,126,226
1664,93,53,0,1,112,148,260,40,63,103
1980,93,17,0,1,4,277,281,12,37,49
2084,93,18,1,0,556,141,697,148,136,284
2230,93,12,0,0,353,1012,1365,36,22,58
2264,93,5,0,1,187,30,217,210,209,419
2757,93,288,1,0,118,165,283,570,1069,1639
2768,93,23,0,0,355,17,372,66,73,139
3340,93,199,2,1,35,322,357,193,516,709
3475,93,20,0,0,7,216,223,2,25,27
3557,93,10,0,2,217,180,397,61,52,113
3598,93,88,1,0,2,142,144,3,170,173
3772,93,19,0,0,6,173,179,493,515,1008
3826,93,134,0,0,161,29,190,497,800,1297
3940,93,39,0,1,51,180,231,137,189,326
304,92,34,0,0,13,104,117,14,52,66
475,92,63,2,1,1272,921,2193,171,185,356
511,92,95,1,2,122,42,164,273,308,581
772,92,25,0,0,76,295,371,35,76,111
1749,92,63,1,0,134,0,134,76,0,76
2034,92,370,1,2,159,28,187,157,1443,1600
2136,92,150,2,1,0,203,203,1,441,442
2416,92,14,0,1,14,220,234,306,325,631
3268,92,18,2,1,310,1917,2227,156,165,321
3613,92,70,0,1,68,172,240,113,244,357
3721,92,55,0,0,110,299,409,188,305,493
4023,92,7,0,1,282,106,388,18,12,30
536,91,66,0,1,129,255,384,92,153,245
576,91,10,0,0,686,263,949,94,84,178
1339,91,32,0,0,86,405,491,67,93,160
2138,91,20,0,0,44,427,471,24,58,82
2355,91,435,1,2,56,52,108,88,1697,1785
2447,91,83,0,0,304,267,571,368,475,843
2525,91,59,0,0,38,185,223,96,221,317
2551,91,18,0,1,0,250,250,242,346,588
2819,91,17,0,0,69,194,263,32,36,68
3000,91,36,0,1,302,421,723,385,420,805
3941,91,45,0,1,114,116,230,491,457,948
693,90,39,0,1,48,196,244,252,307,559
1213,90,16,0,1,16,228,244,158,177,335
1484,90,172,1,0,3,128,131,26,525,551
1853,90,20,0,1,423,342,765,328,301,629
2054,90,7,0,0,59,201,260,104,107,211
2587,90,9,2,1,140,560,700,26,1,27
2590,90,193,2,1,136,40,176,289,653,942
3244,90,1,0,0,75,277,352,1,2,3
1053,89,89,2,0,225,262,487,202,227,429
1348,89,10,0,0,96,137,233,11,23,34
1703,89,22,0,1,7,354,361,196,219,415
1902,89,53,2,1,412,98,510,111,47,158
1917,89,48,0,0,41,138,179,37,132,169
2035,89,5,0,0,346,0,346,5,0,5
2149,89,35,0,0,56,157,213,208,277,485
2294,89,224,1,1,22,78,100,85,457,542
2507,89,56,0,0,132,84,216,1092,1194,2286
2627,89,38,0,1,379,409,788,694,510,1204
2674,89,41,0,0,227,196,423,104,83,187
2874,89,14,0,0,20,182,202,697,703,1400
3127,89,206,2,1,6,355,361,10,1019,1029
3232,89,7,0,1,194,0,194,8,0,8
3453,89,59,0,0,37,225,262,168,287,455
3898,89,24,0,1,67,134,201,103,64,167
3973,89,220,2,1,241,23,264,437,498,935
627,88,52,0,1,65,203,268,189,190,379
1065,88,97,1,0,2,114,116,3,256,259
1314,88,8,0,0,37,182,219,65,66,131
2027,88,12,2,1,502,499,1001,23,0,23
2407,88,63,0,1,180,99,279,349,525,874
3203,88,63,0,1,38,217,255,139,291,430
124,87,105,2,1,167,185,352,293,442,735
998,87,19,0,1,144,146,290,149,137,286
2086,87,30,0,0,44,203,247,46,95,141
2189,87,6,0,1,128,363,491,99,92,191
2253,87,32,0,0,303,545,848,33,64,97
2521,87,35,0,0,28,147,175,281,344,625
2942,87,38,2,1,16,218,234,420,468,888
3350,87,18,1,0,139,0,139,32,0,32
3497,87,18,0,0,52,252,304,154,194,348
411,86,179,2,1,157,78,235,193,790,983
759,86,72,0,0,169,59,228,373,267,640
1172,86,94,0,0,154,115,269,367,611,978
1212,86,15,0,1,1,165,166,7,55,62
1676,86,61,1,0,24,138,162,71,179,250
1821,86,43,0,1,75,308,383,41,130,171
1845,86,68,2,1,433,61,494,545,97,642
2760,86,48,0,1,98,59,157,71,19,90
2822,86,73,0,0,31,118,149,87,188,275
3151,86,43,2,1,516,257,773,105,40,145
3930,86,46,0,1,51,125,176,37,130,167
222,85,4,0,1,21,244,265,0,5,5
873,85,18,0,1,467,177,644,368,393,761
1076,85,73,1,0,108,0,108,104,0,104
1097,85,49,2,1,240,44,284,265,169,434
1142,85,44,0,0,475,347,822,556,566,1122
1546,85,67,0,1,132,59,191,491,527,1018
1701,85,12,0,0,721,573,1294,24,58,82
2427,85,189,2,1,51,86,137,178,530,708
2482,85,21,0,1,69,228,297,146,176,322
2491,85,18,0,1,334,787,1121,7,45,52
2593,85,7,0,1,58,76,134,219,217,436
2789,85,5,0,1,15,320,335,159,163,322
2868,85,27,0,1,140,385,525,80,103,183
3042,85,5,0,1,145,8,153,41,33,74
3142,85,19,2,1,627,521,1148,63,43,106
3265,85,97,2,1,2,214,216,44,305,349
3386,85,12,0,1,36,397,433,129,151,280
3457,85,37,0,1,61,137,198,568,572,1140
3603,85,31,2,1,362,218,580,60,19,79
3767,85,7,0,1,8,370,378,70,86,156
3998,85,58,2,1,217,38,255,153,64,217
592,84,151,2,1,30,129,159,65,602,667
812,84,3,0,0,171,0,171,3,0,3
1187,84,24,0,0,24,228,252,4,45,49
1990,84,12,0,1,77,442,519,58,65,123
2377,84,36,2,1,289,131,420,70,27,97
2390,84,79,2,1,594,501,1095,111,318,429
2471,84,14,0,1,142,111,253,165,162,327
2479,84,43,0,0,19,120,139,108,194,302
2583,84,29,0,0,21,621,642,9,113,122
2870,84,29,0,0,10,125,135,354,390,744
3039,84,19,0,1,56,398,454,278,313,591
3309,84,32,0,0,10,171,181,5,62,67
3971,84,88,0,1,38,177,215,192,419,611
243,83,140,1,2,55,89,144,139,303,442
920,83,130,2,1,325,16,341,350,487,837
921,83,210,2,1,129,20,149,237,573,810
1612,83,101,0,0,232,36,268,2296,2340,4636
2043,83,54,0,1,389,151,540,670,597,1267
2474,83,25,0,1,49,146,195,179,174,353
2733,83,26,2,1,7,946,953,2,76,78
3121,83,31,2,1,191,294,485,194,146,340
3190,83,12,0,0,46,208,254,49,48,97
3524,83,60,0,0,160,162,322,543,570,1113
3813,83,16,0,0,112,58,170,23,30,53
925,82,5,0,1,135,27,162,1646,1640,3286
1181,82,166,0,0,5,167,172,114,762,876
1277,82,23,0,1,104,120,224,70,68,138
1347,82,24,0,0,24,183,207,80,114,194
1564,82,30,0,0,409,300,709,157,27,184
1679,82,82,0,0,32,147,179,162,322,484
1868,82,234,2,2,70,133,203,512,114,626
1913,82,33,0,1,37,210,247,806,823,1629
2075,82,124,2,1,180,0,180,202,212,414
2227,82,36,0,1,126,73,199,855,853,1708
3513,82,13,0,1,156,184,340,17,16,33
3544,82,63,0,1,94,187,281,339,445,784
3569,82,37,2,1,0,219,219,5,67,72
3683,82,34,0,0,139,102,241,249,263,512
3757,82,113,2,1,17,184,201,131,697,828
3804,82,172,2,1,18,257,275,426,1011,1437
3819,82,34,0,0,49,111,160,259,274,533
3910,82,75,0,0,37,189,226,595,684,1279
774,81,71,0,1,106,113,219,230,227,457
1002,81,25,2,1,221,199,420,50,1,51
1183,81,8,0,1,105,0,105,8,0,8
1285,81,22,0,0,130,25,155,42,28,70
1383,81,301,1,2,14,123,137,9,836,845
1714,81,152,2,1,39,291,330,69,521,590
1757,81,43,0,1,222,269,491,767,806,1573
2228,81,7,0,0,371,333,704,13,5,18
2477,81,23,2,1,80,485,565,24,5,29
2684,81,19,0,0,116,58,174,72,74,146
2771,81,340,0,0,458,95,553,92,1817,1909
2825,81,19,0,1,16,181,197,6,31,37
3324,81,13,0,0,118,439,557,60,70,130
3642,81,127,1,0,4,141,145,27,286,313
3875,81,12,0,1,138,157,295,191,184,375
4019,81,92,2,1,366,0,366,248,0,248
322,80,38,2,1,624,776,1400,461,490,951
635,80,48,2,1,562,0,562,155,0,155
1052,80,57,2,1,361,0,361,208,0,208
1843,80,11,0,0,379,352,731,28,25,53
1918,80,46,1,0,180,0,180,114,0,114
2026,80,66,2,1,219,135,354,96,166,262
2284,80,63,0,1,92,89,181,221,367,588
2299,80,6,0,0,1834,1495,3329,14,8,22
2343,80,163,2,1,20,212,232,229,436,665
2961,80,21,0,1,124,0,124,25,0,25
3002,80,55,0,0,18,106,124,483,474,957
3014,80,13,0,1,65,96,161,4,14,18
3251,80,22,0,1,160,36,196,231,209,440
3728,80,10,0,0,110,70,180,44,45,89
817,79,1,0,0,2,135,137,16,19,35
1004,79,12,0,1,130,209,339,613,600,1213
1445,79,28,2,1,232,91,323,61,14,75
2007,79,26,2,1,240,167,407,1095,1142,2237
2093,79,12,0,0,37,372,409,22,40,62
2312,79,29,0,1,138,115,253,167,120,287
2385,79,26,0,0,267,284,551,150,173,323
2495,79,18,2,1,40,318,358,8,27,35
2650,79,142,1,2,150,206,356,326,829,1155
2995,79,13,0,1,342,684,1026,179,245,424
3237,79,4,0,0,56,212,268,27,30,57
3407,79,47,0,0,138,21,159,150,97,247
3602,79,24,0,0,143,116,259,92,84,176
3980,79,95,0,0,83,128,211,169,266,435
399,78,10,0,0,158,137,295,407,392,799
837,78,14,0,0,357,250,607,607,567,1174
1590,78,17,1,0,81,3,84,19,1,20
1690,78,106,0,0,128,155,283,584,798,1382
1800,78,30,2,1,134,59,193,207,171,378
1965,78,24,0,1,67,87,154,185,171,356
1973,78,45,0,1,77,145,222,158,195,353
2053,78,28,2,1,316,699,1015,17,43,60
2232,78,19,0,1,173,0,173,25,0,25
2442,78,9,0,0,93,405,498,12,22,34
3067,78,168,0,1,4,123,127,212,885,1097
3355,78,9,0,1,180,82,262,12,3,15
3789,78,5,0,1,200,248,448,35,31,66
3868,78,87,2,1,341,33,374,445,484,929
22,77,50,0,0,87,56,143,123,110,233
689,77,40,0,1,72,338,410,101,191,292
934,77,48,2,1,1491,1168,2659,627,426,1053
1455,77,38,0,0,178,0,178,71,0,71
1525,77,64,0,1,48,117,165,375,434,809
2041,77,33,0,1,442,246,688,573,566,1139
2282,77,18,0,1,284,159,443,39,54,93
2410,77,18,0,1,147,222,369,152,140,292
2519,77,13,0,1,177,166,343,28,38,66
2710,77,470,1,0,36,74,110,34,1590,1624
3313,77,324,1,2,126,8,134,216,1393,1609
3654,77,68,1,0,93,46,139,68,143,211
3820,77,2,0,1,131,3,134,64,62,126
3948,77,8,0,1,32,409,441,3,11,14
1537,76,13,0,2,34,143,177,109,186,295
1943,76,16,0,1,525,0,525,60,44,104
2391,76,5,2,1,59,450,509,52,47,99
2532,76,18,0,1,416,417,833,130,133,263
2586,76,41,0,1,99,165,264,1196,1271,2467
2970,76,37,0,0,117,128,245,40,71,111
2982,76,19,0,1,42,188,230,156,149,305
3269,76,46,0,0,53,77,130,17,72,89
3412,76,20,0,1,145,40,185,237,162,399
3773,76,76,0,0,213,239,452,563,676,1239
3895,76,141,1,2,56,58,114,33,242,275
3916,76,110,0,0,155,38,193,833,372,1205
273,75,48,0,0,2,104,106,9,79,88
474,75,26,0,0,70,90,160,22,32,54
1506,75,125,1,0,6,149,155,17,744,761
1791,75,55,0,0,130,27,157,174,152,326
1795,75,2,0,0,6,115,121,39,41,80
1851,75,20,0,1,0,282,282,44,69,113
1942,75,11,0,1,171,237,408,334,330,664
1957,75,101,0,1,266,0,266,368,0,368
1998,75,19,2,1,93,84,177,27,0,27
2039,75,10,0,1,3,250,253,167,179,346
2063,75,39,0,1,103,16,119,224,171,395
2191,75,13,0,1,46,629,675,68,70,138
2642,75,3,0,0,59,171,230,131,132,263
3049,75,2,2,1,11,567,578,2,2,4
3281,75,16,0,0,21,144,165,27,46,73
3295,75,23,0,1,88,85,173,17,21,38
3384,75,47,2,1,221,210,431,217,128,345
3504,75,9,0,0,85,195,280,58,64,122
3567,75,90,2,1,196,110,306,191,33,224
3703,75,13,0,1,10,387,397,40,74,114
3985,75,17,0,0,431,75,506,165,148,313
384,74,52,0,1,0,201,201,20,158,178
978,74,17,0,0,138,0,138,19,0,19
1095,74,36,0,0,39,246,285,226,309,535
1418,74,74,0,0,117,88,205,265,337,602
1617,74,23,1,0,275,0,275,28,0,28
1948,74,40,1,2,86,0,86,48,0,48
1982,74,12,0,0,96,153,249,20,2,22
2214,74,9,0,1,10,130,140,5,13,18
2703,74,90,2,1,494,70,564,439,285,724
2714,74,19,0,1,46,390,436,166,204,370
3076,74,50,2,1,1,470,471,5,154,159
3110,74,131,2,1,8,244,252,113,586,699
3267,74,146,1,1,16,123,139,152,576,728
3577,74,87,0,0,136,39,175,611,827,1438
3946,74,30,0,1,103,0,103,67,0,67
1312,73,24,0,1,69,57,126,378,357,735
1661,73,26,0,0,199,40,239,24,79,103
1744,73,43,2,1,3,706,709,8,252,260
1881,73,28,1,0,87,0,87,47,0,47
2148,73,6,0,1,88,53,141,7,0,7
2190,73,237,2,1,230,6,236,509,1262,1771
2713,73,15,0,0,251,0,251,23,0,23
2853,73,32,0,1,242,45,287,891,858,1749
3674,73,8,0,0,111,184,295,57,55,112
586,72,5,0,0,46,421,467,9,9,18
955,72,20,0,0,252,76,328,22,6,28
1309,72,237,2,1,22,100,122,29,977,1006
2192,72,4,0,1,169,367,536,5,7,12
2360,72,1,0,1,11,314,325,0,1,1
2404,72,6,0,0,89,707,796,66,78,144
2692,72,22,0,1,117,51,168,70,47,117
3013,72,30,0,1,74,98,172,33,68,101
3164,72,26,0,1,165,6,171,548,496,1044
3680,72,11,0,0,241,451,692,29,20,49
4031,72,11,0,1,263,394,657,7,22,29
730,71,45,0,0,56,112,168,180,206,386
966,71,20,0,0,356,0,356,67,0,67
1394,71,2,0,1,135,0,135,2,0,2
1780,71,10,0,0,72,114,186,13,11,24
2045,71,15,0,0,15,176,191,5,24,29
2401,71,226,1,0,32,109,141,92,573,665
2843,71,9,0,1,294,444,738,9,95,104
3068,71,26,0,1,87,107,194,306,428,734
3233,71,70,0,1,1,253,254,21,205,226
3867,71,56,1,0,2,141,143,0,110,110
3939,71,17,0,1,70,147,217,216,228,444
3990,71,4,0,1,24,347,371,17,12,29
4005,71,5,0,1,63,409,472,12,13,25
4068,71,51,2,1,40,124,164,115,191,306
531,70,42,2,1,455,0,455,96,0,96
1247,70,20,0,0,58,102,160,596,590,1186
2609,70,12,0,0,187,379,566,97,107,204
2708,70,7,0,1,59,168,227,44,44,88
2960,70,13,0,0,108,137,245,93,110,203
3065,70,49,0,0,100,36,136,81,49,130
3106,70,17,0,1,41,93,134,129,131,260
3366,70,70,2,1,242,141,383,644,633,1277
3532,70,15,0,0,107,10,117,16,4,20
3561,70,35,0,1,44,582,626,79,247,326
3863,70,72,0,1,630,253,883,198,188,386
581,69,39,0,1,591,132,723,378,205,583
727,69,10,0,0,13,127,140,112,124,236
1220,69,7,0,1,245,263,508,61,53,114
1660,69,23,0,0,144,0,144,41,0,41
1736,69,83,1,1,3,86,89,8,167,175
2022,69,16,0,1,38,219,257,102,122,224
2242,69,8,0,1,177,297,474,131,140,271
2244,69,12,0,1,219,219,438,23,51,74
2270,69,6,0,1,89,15,104,342,337,679
2452,69,61,0,1,13,367,380,14,154,168
2513,69,21,2,1,196,442,638,19,18,37
2798,69,12,0,1,118,164,282,307,305,612
2865,69,1,2,1,236,1090,1326,1,0,1
3273,69,26,0,0,247,0,247,33,0,33
3660,69,279,1,2,22,92,114,101,1075,1176
3672,69,26,0,0,34,86,120,88,119,207
3685,69,16,0,1,60,160,220,134,152,286
3714,69,24,0,0,129,345,474,135,141,276
3750,69,32,0,0,79,700,779,127,136,263
3801,69,32,0,1,110,169,279,505,561,1066
867,68,70,1,2,80,0,80,85,0,85
923,68,17,0,1,26,105,131,88,102,190
1136,68,6,0,1,59,138,197,0,6,6
1163,68,92,0,1,28,107,135,162,227,389
1719,68,52,2,1,182,23,205,221,116,337
1808,68,99,0,2,150,71,221,125,28,153
2555,68,61,2,1,118,51,169,449,17,466
2888,68,88,0,0,104,28,132,468,445,913
2901,68,10,0,1,26,304,330,47,52,99
2906,68,25,0,1,0,174,174,6,64,70
2936,68,40,0,1,103,37,140,1039,988,2027
3317,68,4,0,1,58,160,218,146,147,293
3846,68,11,0,0,488,578,1066,130,134,264
4055,68,28,0,1,57,110,167,78,127,205
326,67,26,0,1,17,284,301,18,61,79
783,67,21,2,1,17,181,198,53,60,113
891,67,20,2,1,180,100,280,29,4,33
1139,67,69,2,1,109,21,130,94,44,138
1248,67,92,0,0,209,106,315,286,142,428
1574,67,28,0,1,169,706,875,27,109,136
1643,67,18,0,0,47,66,113,41,41,82
1649,67,3,0,0,86,189,275,5,8,13
1834,67,12,0,1,87,0,87,31,17,48
1967,67,42,2,1,109,2,111,155,78,233
2060,67,178,2,1,177,70,247,127,663,790
2062,67,22,0,1,52,74,126,341,346,687
2322,67,36,0,1,396,240,636,57,90,147
2354,67,43,0,0,93,72,165,335,236,571
2542,67,19,0,0,100,136,236,41,57,98
2662,67,21,0,0,7,162,169,28,136,164
2712,67,60,0,1,72,68,140,112,102,214
3126,67,46,2,1,230,1,231,43,16,59
3501,67,11,2,1,41,532,573,7,9,16
3580,67,21,0,0,128,92,220,76,90,166
3722,67,39,2,1,58,271,329,11,56,67
3835,67,74,0,1,96,78,174,344,329,673
1814,66,17,2,1,52,137,189,24,5,29
2015,66,18,0,1,87,77,164,25,24,49
2108,66,17,0,1,144,84,228,335,358,693
2378,66,39,2,1,97,145,242,841,853,1694
2522,66,184,2,1,8,335,343,120,603,723
2527,66,24,2,1,175,110,285,346,328,674
2679,66,12,0,1,24,210,234,95,112,207
2761,66,20,2,1,236,743,979,20,27,47
2773,66,197,2,1,69,64,133,210,1284,1494
3103,66,10,0,1,413,49,462,38,33,71
3291,66,71,2,1,2,242,244,58,257,315
3306,66,2,0,1,5,128,133,0,2,2
3747,66,362,1,1,63,19,82,86,1960,2046
3979,66,93,2,1,423,2,425,721,424,1145
691,65,9,0,1,99,77,176,247,235,482
713,65,91,0,0,65,54,119,527,529,1056
975,65,38,1,2,81,0,81,41,0,41
1393,65,376,1,2,45,45,90,166,1624,1790
1938,65,58,0,0,371,85,456,578,597,1175
2252,65,14,0,0,47,147,194,21,25,46
2721,65,4,0,2,30,157,187,17,27,44
2855,65,12,0,1,563,362,925,792,794,1586
3810,65,17,0,1,56,86,142,105,85,190
664,64,16,1,0,10,85,95,6,27,33
908,64,11,0,1,10,130,140,488,496,984
1241,64,50,0,1,39,69,108,88,33,121
1432,64,48,2,1,25,165,190,152,197,349
1524,64,29,0,0,31,203,234,248,285,533
1713,64,28,1,0,88,0,88,39,0,39
2038,64,75,0,0,54,220,274,158,154,312
2606,64,6,0,0,32,225,257,10,8,18
2800,64,20,0,1,67,82,149,774,793,1567
2862,64,72,0,1,8,113,121,270,440,710
2863,64,14,0,1,71,87,158,346,340,686
2946,64,21,0,1,134,115,249,414,468,882
3238,64,37,0,1,119,109,228,163,212,375
3473,64,14,2,1,30,145,175,34,44,78
3508,64,59,1,0,117,80,197,58,98,156
2146,63,115,2,1,23,175,198,37,425,462
2168,63,131,0,0,44,29,73,391,77,468
2882,63,39,2,0,77,372,449,13,64,77
3761,63,7,0,1,9,251,260,131,146,277
3785,63,26,0,0,49,56,105,119,135,254
3982,63,17,0,1,130,275,405,32,69,101
4062,63,49,2,1,95,469,564,133,59,192
652,62,13,0,1,1277,913,2190,203,193,396
653,62,16,2,1,1072,1376,2448,14,45,59
760,62,13,0,1,266,45,311,191,176,367
1164,62,86,0,0,60,72,132,112,244,356
1276,62,27,0,0,2,107,109,12,53,65
1856,62,9,0,0,114,0,114,12,0,12
2114,62,36,0,1,211,137,348,464,416,880
2445,62,7,0,1,65,108,173,84,81,165
2504,62,13,0,0,42,159,201,5,25,30
2547,62,69,2,1,8,227,235,57,203,260
2937,62,9,0,1,675,383,1058,19,12,31
2984,62,21,0,0,83,159,242,43,49,92
2985,62,26,0,1,159,288,447,37,40,77
3362,62,2,0,0,329,175,504,2,0,2
3413,62,445,1,2,11,62,73,42,1644,1686
3527,62,50,0,0,32,97,129,43,98,141
1192,61,38,0,1,92,24,116,367,414,781
1199,61,21,0,0,75,0,75,50,0,50
2024,61,13,0,1,56,361,417,9,21,30
2077,61,10,0,1,69,28,97,236,238,474
2095,61,53,1,2,93,118,211,95,96,191
2318,61,28,2,1,356,411,767,47,27,74
2365,61,16,2,1,232,212,444,116,98,214
2881,61,46,0,1,137,332,469,165,312,477
3563,61,7,0,1,281,12,293,14,6,20
3840,61,37,2,1,1,244,245,4,93,97
4013,61,14,0,1,60,122,182,19,26,45
1818,60,36,0,0,57,11,68,112,119,231
1861,60,55,2,1,221,43,264,63,76,139
2046,60,42,0,0,53,253,306,62,119,181
2052,60,172,2,1,121,110,231,145,649,794
2325,60,7,0,1,606,543,1149,25,20,45
2418,60,32,0,0,63,17,80,422,478,900
2487,60,7,0,1,120,181,301,27,26,53
2857,60,12,0,1,122,349,471,64,71,135
3143,60,7,0,0,76,204,280,47,51,98
3856,60,54,0,1,70,92,162,763,780,1543
3921,60,408,1,0,101,0,101,149,1273,1422
3970,60,5,0,1,9,87,96,89,95,184
862,59,155,0,0,49,76,125,284,115,399
1440,59,14,0,1,3,66,69,9,34,43
1552,59,61,0,0,58,77,135,14,91,105
1559,59,28,2,1,631,338,969,294,234,528
1922,59,166,2,1,42,129,171,16,584,600
2286,59,30,0,1,200,161,361,251,292,543
2367,59,3,0,0,10,144,154,6,7,13
2510,59,15,0,0,79,40,119,89,63,152
2846,59,34,2,1,98,280,378,451,351,802
2943,59,32,2,1,141,3,144,38,67,105
2999,59,28,0,1,43,88,131,485,486,971
3097,59,40,0,0,33,75,108,66,22,88
3153,59,20,2,1,21,89,110,146,141,287
3294,59,60,0,0,31,94,125,214,181,395
3454,59,23,0,1,50,89,139,186,237,423
3488,59,29,1,0,3,96,99,121,175,296
3526,59,16,0,0,54,41,95,21,22,43
3600,59,215,2,1,163,21,184,254,730,984
3811,59,1,0,1,14,200,214,0,1,1
3830,59,14,0,0,114,189,303,26,33,59
3884,59,48,0,1,27,182,209,66,208,274
3903,59,5,0,1,179,367,546,7,3,10
889,58,3,0,1,53,56,109,35,32,67
1140,58,7,0,0,2,101,103,4,14,18
1783,58,9,0,0,11,82,93,2,12,14
1838,58,38,2,1,253,0,253,183,0,183
2200,58,17,2,1,178,184,362,1542,1546,3088
2440,58,10,2,1,5,304,309,6,55,61
2566,58,9,0,0,201,280,481,3,13,16
2577,58,15,0,0,254,104,358,37,35,72
2814,58,3,0,0,34,641,675,1,3,4
2919,58,187,1,1,55,30,85,363,946,1309
3311,58,29,0,1,176,264,440,77,169,246
3847,58,5,0,0,30,255,285,20,21,41
180,57,35,1,0,1,77,78,2,42,44
642,57,27,1,2,67,0,67,30,0,30
1413,57,28,0,1,186,42,228,277,300,577
1498,57,3,0,1,111,82,193,9,6,15
2271,57,296,2,0,58,26,84,272,980,1252
2497,57,33,0,1,111,57,168,131,151,282
2616,57,9,0,1,77,0,77,143,115,258
2873,57,71,0,1,94,73,167,689,567,1256
2891,57,8,2,1,123,0,123,11,0,11
3016,57,8,0,0,215,148,363,9,1,10
3256,57,11,0,0,59,148,207,128,144,272
3358,57,22,0,0,6,71,77,2,30,32
3491,57,2,0,1,2,132,134,53,55,108
3709,57,63,0,0,29,66,95,134,163,297
807,56,6,0,1,0,87,87,311,367,678
887,56,17,2,1,987,777,1764,31,6,37
1014,56,22,0,0,35,73,108,230,245,475
2236,56,48,1,2,73,0,73,75,0,75
2277,56,141,0,0,33,90,123,830,1406,2236
2301,56,4,0,1,99,74,173,17,11,28
2310,56,18,0,1,3,332,335,2,99,101
2400,56,20,0,1,105,57,162,851,847,1698
2607,56,14,0,0,578,111,689,37,28,65
2820,56,13,0,0,63,45,108,11,8,19
3242,56,38,0,0,29,125,154,137,180,317
3490,56,279,1,1,6,68,74,15,839,854
3904,56,8,0,1,98,49,147,82,83,165
3981,56,12,0,0,243,349,592,101,115,216
4021,56,9,0,0,30,179,209,65,60,125
1323,55,6,2,1,48,550,598,60,44,104
1577,55,9,0,1,3,345,348,26,33,59
1645,55,36,0,0,166,163,329,91,140,231
1819,55,136,0,0,31,34,65,89,284,373
1854,55,28,1,0,57,25,82,33,16,49
2042,55,37,0,1,30,147,177,114,169,283
2185,55,64,0,1,0,460,460,9,114,123
2296,55,53,0,1,88,79,167,450,547,997
2701,55,2,0,1,307,144,451,348,346,694
2836,55,64,0,0,61,52,113,627,660,1287
3112,55,39,0,0,62,101,163,66,50,116
3188,55,13,2,1,116,393,509,16,32,48
3711,55,49,2,1,41,114,155,107,195,302
3731,55,54,0,1,6,156,162,2,308,310
4007,55,2,0,1,337,282,619,16,16,32
992,54,206,0,0,39,57,96,396,806,1202
1116,54,141,2,1,66,68,134,95,471,566
1326,54,4,0,1,4,98,102,20,25,45
1545,54,24,0,1,81,97,178,158,208,366
2154,54,14,0,0,57,141,198,40,37,77
2366,54,115,1,2,116,29,145,501,375,876
2595,54,12,0,1,101,14,115,852,844,1696
2623,54,45,0,1,91,33,124,664,948,1612
2645,54,10,0,0,5,94,99,159,176,335
2850,54,20,2,1,242,507,749,8,35,43
2994,54,10,0,1,3,125,128,62,79,141
3001,54,15,0,0,1,88,89,19,37,56
3162,54,12,0,0,128,38,166,48,32,80
3181,54,56,0,0,11,71,82,63,155,218
3425,54,10,0,0,43,106,149,27,24,51
3732,54,15,0,0,16,95,111,11,28,39
607,53,99,0,0,101,3,104,53,305,358
749,53,54,0,0,63,78,141,232,202,434
784,53,35,0,0,32,37,69,270,309,579
1113,53,53,2,1,109,0,109,47,297,344
1205,53,9,0,1,49,17,66,544,549,1093
1374,53,38,2,1,116,61,177,237,125,362
1462,53,33,1,0,62,0,62,92,0,92
1765,53,14,0,0,46,70,116,17,14,31
1981,53,4,0,0,405,589,994,58,28,86
2173,53,23,0,0,96,93,189,216,281,497
2327,53,56,0,0,176,201,377,329,296,625
2383,53,119,2,1,25,99,124,53,959,1012
2517,53,137,2,1,88,24,112,425,492,917
3035,53,9,0,1,128,112,240,40,45,85
3080,53,52,2,1,140,30,170,156,73,229
3111,53,12,0,0,130,157,287,49,30,79
943,52,28,0,1,54,42,96,71,17,88
1106,52,160,2,1,136,4,140,239,127,366
1692,52,26,0,1,178,240,418,244,300,544
1865,52,6,2,1,4,322,326,4,9,13
2096,52,4,0,2,113,0,113,59,54,113
2550,52,45,2,1,335,7,342,157,27,184
2648,52,21,0,0,19,70,89,20,26,46
2711,52,3,0,1,16,96,112,622,615,1237
2799,52,20,0,1,67,153,220,86,107,193
2828,52,7,0,0,157,162,319,10,37,47
2880,52,21,0,0,3,75,78,65,76,141
3006,52,12,0,0,235,260,495,144,124,268
3131,52,7,0,1,264,13,277,223,215,438
3292,52,28,0,1,284,252,536,360,376,736
3344,52,68,2,1,111,0,111,127,0,127
3433,52,4,2,1,80,260,340,2,4,6
3464,52,6,0,0,11,104,115,0,7,7
3825,52,3,0,1,8,108,116,364,367,731
3849,52,85,0,0,37,117,154,235,448,683
3915,52,383,1,0,59,3,62,175,1113,1288
4039,52,5,0,0,82,592,674,4,7,11
544,51,23,0,1,126,10,136,111,30,141
578,51,35,0,1,68,66,134,431,446,877
684,51,18,0,1,207,199,406,437,444,881
928,51,11,0,1,182,900,1082,11,22,33
957,51,7,1,0,0,78,78,0,7,7
1122,51,173,1,1,3,69,72,199,745,944
1207,51,14,0,0,60,64,124,8,12,20
1960,51,3,0,1,36,131,167,68,69,137
2164,51,2,0,0,85,135,220,21,24,45
2259,51,27,0,0,121,43,164,5,64,69
2333,51,32,0,0,107,0,107,135,0,135
2459,51,10,0,1,44,90,134,76,87,163
2632,51,16,0,1,25,106,131,127,134,261
2835,51,8,0,1,362,501,863,40,40,80
2944,51,3,0,0,84,7,91,21,18,39
3009,51,110,1,0,2,59,61,105,421,526
3077,51,31,0,1,32,43,75,272,261,533
3105,51,5,0,1,73,207,280,90,96,186
3129,51,19,0,1,50,53,103,21,23,44
3191,51,19,0,1,1,167,168,32,69,101
3223,51,10,0,0,87,206,293,11,11,22
3252,51,12,2,1,119,221,340,37,42,79
4000,51,283,2,1,10,47,57,241,808,1049
1560,50,100,0,0,5,65,70,116,452,568
2069,50,45,0,1,59,476,535,11,180,191
2341,50,21,0,0,21,70,91,250,387,637
2426,50,9,1,1,75,4,79,174,549,723
2485,50,16,0,1,64,30,94,222,212,434
2628,50,2,1,1,113,0,113,2,0,2
2917,50,78,0,1,5,301,306,110,290,400
2989,50,10,0,1,41,488,529,5,23,28
3054,50,51,2,1,284,356,640,182,318,500
3072,50,35,1,0,56,0,56,39,0,39
3376,50,24,2,1,6,107,113,56,93,149
3844,50,1,0,1,4,191,195,26,27,53
3926,50,9,0,0,64,91,155,15,18,33
1579,49,9,0,0,45,34,79,12,9,21
2665,49,6,0,1,4,98,102,63,181,244
2753,49,78,2,1,5,115,120,107,296,403
2759,49,2,2,0,770,860,1630,1,3,4
2893,49,2,2,1,43,310,353,20,18,38
3417,49,2,0,1,30,99,129,2,0,2
3675,49,8,0,0,159,122,281,19,16,35
3766,49,13,0,1,66,20,86,43,107,150
4040,49,12,0,1,1,143,144,4,17,21
683,48,244,0,0,10,91,101,35,884,919
2071,48,3,0,1,1,101,102,19,26,45
2109,48,28,0,0,27,63,90,551,519,1070
2376,48,12,0,0,176,671,847,11,6,17
2622,48,30,0,1,51,99,150,256,283,539
2670,48,9,0,0,78,0,78,13,0,13
2758,48,345,2,1,59,8,67,92,1535,1627
2805,48,62,0,1,110,80,190,88,155,243
2932,48,19,0,1,67,73,140,364,385,749
2939,48,45,2,1,146,351,497,23,238,261
3030,48,11,0,1,458,68,526,40,36,76
3418,48,3,0,0,126,429,555,125,127,252
3578,48,27,0,1,56,31,87,102,122,224
3582,48,13,2,1,160,764,924,7,63,70
3861,48,10,0,0,4,122,126,23,39,62
3976,48,80,2,1,45,96,141,295,551,846
847,47,10,0,0,15,73,88,586,591,1177
1090,47,15,0,1,88,21,109,597,590,1187
1375,47,5,0,0,5,95,100,3,8,11
1457,47,22,0,0,36,47,83,776,798,1574
1711,47,21,2,1,3,166,169,15,44,59
1785,47,17,0,1,75,153,228,244,241,485
1910,47,7,0,0,1,102,103,0,10,10
2165,47,18,2,1,64,94,158,321,339,660
2199,47,5,2,1,21,860,881,2,41,43
2883,47,6,0,1,28,50,78,1035,1035,2070
3755,47,30,2,1,116,273,389,105,149,254
490,46,10,0,0,95,226,321,11,1,12
620,46,32,1,0,57,0,57,73,0,73
703,46,30,0,0,39,65,104,163,353,516
1278,46,43,0,1,183,35,218,552,485,1037
1351,46,28,0,0,30,28,58,28,16,44
1558,46,6,2,1,22,134,156,17,28,45
1743,46,8,0,0,2,65,67,3,11,14
1779,46,28,0,0,14,60,74,360,418,778
1961,46,10,0,0,158,0,158,54,0,54
2326,46,8,0,1,69,112,181,217,143,360
2352,46,22,0,0,91,115,206,25,47,72
2575,46,6,0,1,11,123,134,201,226,427
2655,46,12,0,1,239,117,356,32,41,73
2838,46,5,0,0,135,9,144,5,5,10
2912,46,16,0,1,42,134,176,590,570,1160
3011,46,19,0,0,2,56,58,244,279,523
3382,46,1,0,0,25,201,226,78,77,155
3383,46,28,2,1,300,0,300,61,0,61
3397,46,29,0,1,137,37,174,412,405,817
3485,46,10,1,2,47,0,47,11,0,11
3565,46,24,2,1,114,0,114,75,0,75
3574,46,20,0,1,166,251,417,169,188,357
3768,46,42,1,2,55,0,55,60,0,60
3796,46,8,0,1,16,128,144,61,73,134
61,45,72,1,2,15,74,89,42,192,234
506,45,51,2,1,41,119,160,70,2,72
559,45,25,0,1,462,216,678,341,352,693
1029,45,91,0,0,1,58,59,20,178,198
1162,45,32,0,0,41,11,52,217,200,417
1279,45,2,0,1,0,103,103,7,10,17
1349,45,89,0,0,45,45,90,192,508,700
1946,45,18,0,1,71,166,237,27,55,82
2006,45,9,0,0,178,114,292,14,14,28
2089,45,27,0,1,41,42,83,773,799,1572
2132,45,17,0,1,27,202,229,70,98,168
2135,45,33,0,1,26,168,194,981,1008,1989
2209,45,16,0,1,167,256,423,134,119,253
2379,45,32,2,1,132,185,317,62,158,220
2535,45,56,0,1,135,1,136,152,189,341
2582,45,14,0,0,39,277,316,5,22,27
2673,45,12,0,0,60,208,268,85,95,180
2689,45,58,2,1,1,172,173,209,320,529
2727,45,10,0,1,77,38,115,4,9,13
2954,45,34,2,1,89,241,330,12,77,89
3220,45,19,2,1,22,240,262,23,30,53
3287,45,15,0,0,77,16,93,25,3,28
3401,45,4,0,1,8,66,74,193,200,393
3550,45,13,0,0,43,64,107,55,72,127
697,44,40,2,1,81,0,81,109,0,109
906,44,28,0,0,108,0,108,140,0,140
1702,44,5,0,0,45,55,100,10,11,21
1764,44,5,1,0,47,0,47,5,0,5
1905,44,15,2,1,38,142,180,116,104,220
2170,44,4,0,0,11,132,143,1,5,6
2349,44,34,1,2,50,0,50,37,0,37
2762,44,4,0,0,295,254,549,18,18,36
3036,44,11,0,1,20,70,90,14,36,50
3074,44,15,0,1,130,270,400,215,230,445
3120,44,15,0,0,27,95,122,46,59,105
3175,44,18,0,0,87,83,170,178,199,377
3405,44,19,0,1,62,79,141,58,78,136
3593,44,3,0,0,46,46,92,5,8,13
3673,44,37,0,0,39,51,90,47,105,152
3718,44,20,2,1,81,88,169,153,128,281
234,43,6,0,1,10,88,98,117,145,262
853,43,6,0,0,1,89,90,12,23,35
1261,43,12,0,1,40,30,70,78,96,174
1575,43,17,0,0,143,0,143,29,0,29
1594,43,7,0,1,46,419,465,19,45,64
1886,43,3,0,0,23,100,123,5,6,11
1925,43,28,0,1,92,49,141,151,160,311
1984,43,26,0,1,58,18,76,300,311,611
2004,43,27,2,1,188,0,188,149,109,258
2056,43,22,0,1,81,0,81,64,0,64
2134,43,17,0,0,113,92,205,69,84,153
2261,43,20,0,0,356,142,498,131,107,238
2340,43,23,2,1,145,0,145,43,0,43
2546,43,6,0,0,52,43,95,10,3,13
2571,43,10,0,0,92,241,333,46,60,106
2663,43,6,0,0,2,87,89,3,11,14
2785,43,24,2,1,55,0,55,44,0,44
2827,43,12,1,2,907,874,1781,17,0,17
2885,43,5,2,1,69,501,570,4,1,5
2978,43,3,0,0,106,8,114,11,12,23
3118,43,64,2,1,3,126,129,10,313,323
3228,43,7,0,1,34,111,145,99,103,202
3449,43,57,0,1,59,55,114,137,317,454
3822,43,56,2,1,88,2,90,398,186,584
3879,43,12,0,0,98,1,99,16,0,16
3892,43,8,0,0,90,0,90,13,0,13
3937,43,10,0,1,81,63,144,21,10,31
3994,43,5,0,0,25,329,354,7,7,14
4044,43,71,0,0,91,80,171,166,394,560
4067,43,11,0,0,49,284,333,44,40,84
1099,42,13,0,1,62,17,79,474,464,938
1179,42,30,0,0,37,57,94,175,191,366
2014,42,49,1,2,42,0,42,61,0,61
2029,42,8,2,1,30,239,269,9,5,14
2202,42,19,0,1,26,197,223,78,147,225
2430,42,1,0,1,38,68,106,491,492,983
2444,42,14,0,0,40,40,80,23,31,54
2464,42,42,0,1,93,115,208,312,388,700
2619,42,9,0,1,91,0,91,13,0,13
2832,42,21,2,1,606,631,1237,832,1322,2154
2945,42,21,0,1,1,79,80,23,94,117
3087,42,9,0,0,9,103,112,3,11,14
3682,42,29,0,0,33,41,74,60,97,157
686,41,43,1,1,56,60,116,258,478,736
914,41,60,2,1,6,146,152,20,190,210
2048,41,15,0,1,73,59,132,89,95,184
2110,41,27,2,1,52,66,118,70,54,124
2198,41,9,0,1,42,160,202,1,17,18
2291,41,8,0,1,303,313,616,162,154,316
2332,41,42,2,1,183,97,280,152,111,263
2767,41,5,0,0,292,0,292,9,0,9
2860,41,18,0,1,84,15,99,403,379,782
2875,41,57,0,1,138,129,267,585,593,1178
3015,41,14,2,1,278,381,659,122,117,239
3330,41,25,2,1,1,211,212,12,67,79
3335,41,7,0,1,16,149,165,80,71,151
3373,41,44,2,1,2,202,204,17,241,258
3390,41,5,0,0,65,419,484,21,24,45
3496,41,2,0,1,117,402,519,0,4,4
3651,41,50,0,0,1,49,50,11,103,114
4057,41,2,0,1,49,110,159,84,86,170
1384,40,74,0,1,111,191,302,323,565,888
1528,40,63,0,1,0,52,52,4,106,110
1641,40,29,2,1,164,15,179,73,8,81
2215,40,13,2,1,23,107,130,155,168,323
2359,40,34,0,1,17,77,94,297,416,713
2448,40,14,0,0,38,26,64,72,89,161
2589,40,29,0,0,108,37,145,28,88,116
2780,40,12,0,1,39,70,109,225,243,468
3159,40,2,0,1,12,349,361,93,91,184
3414,40,26,0,1,35,32,67,381,386,767
3467,40,325,1,2,42,12,54,207,1059,1266
3615,40,74,2,1,14,61,75,225,427,652
3635,40,8,0,0,53,73,126,3,11,14
3764,40,25,1,2,50,0,50,28,0,28
3807,40,12,0,0,12,62,74,30,58,88
4009,40,16,2,1,105,10,115,2192,2042,4234
4016,40,12,0,1,64,118,182,339,362,701
4041,40,25,2,1,56,32,88,110,90,200
375,39,6,0,0,170,350,520,316,220,536
678,39,21,0,1,281,674,955,139,102,241
1017,39,10,0,0,67,0,67,11,0,11
1057,39,27,0,0,49,0,49,55,0,55
1175,39,21,0,1,18,90,108,121,151,272
1218,39,42,0,1,43,18,61,195,140,335
1504,39,59,0,0,43,38,81,69,202,271
1509,39,7,0,1,91,79,170,4,7,11
1992,39,34,0,0,25,116,141,205,274,479
2021,39,10,0,0,30,280,310,4,13,17
2262,39,7,0,1,153,169,322,15,14,29
2463,39,24,0,1,144,35,179,130,184,314
2658,39,7,0,1,73,50,123,118,94,212
2749,39,15,0,1,1348,1274,2622,225,198,423
2754,39,18,0,0,23,44,67,316,326,642
2996,39,45,0,1,27,60,87,548,646,1194
3122,39,8,0,1,88,0,88,30,0,30
3263,39,7,0,1,6,160,166,128,144,272
3573,39,18,0,1,15,91,106,28,51,79
3620,39,13,0,1,19,98,117,69,81,150
3628,39,15,0,0,94,1,95,12,8,20
3749,39,1,0,1,8,70,78,91,90,181
3795,39,3,0,1,6,71,77,41,36,77
1141,38,32,2,1,81,0,81,70,0,70
1155,38,14,0,0,10,320,330,3,31,34
1193,38,4,0,1,7,60,67,148,151,299
1304,38,25,2,1,8,257,265,4,52,56
2082,38,20,0,0,10,83,93,33,134,167
2502,38,13,0,0,92,0,92,27,0,27
2608,38,169,2,1,7,47,54,17,1065,1082
2613,38,113,0,0,45,12,57,341,47,388
2740,38,15,2,1,0,90,90,8,50,58
2903,38,20,0,1,2,56,58,69,43,112
2923,38,16,1,2,63,0,63,21,0,21
3505,38,12,0,2,37,11,48,17,5,22
3547,38,10,2,1,40,124,164,10,23,33
3627,38,18,0,0,67,24,91,15,26,41
3741,38,42,0,1,6,100,106,4,97,101
3961,38,1,0,0,7,81,88,9,10,19
4064,38,3,0,0,7,71,78,259,257,516
176,37,1,0,0,11,77,88,23,24,47
618,37,17,0,0,101,0,101,42,0,42
788,37,114,0,0,44,4,48,533,15,548
997,37,12,0,0,45,71,116,40,46,86
2688,37,42,2,1,211,62,273,238,183,421
2769,37,3,0,0,110,520,630,4,0,4
3198,37,22,2,1,15,98,113,23,78,101
3250,37,18,0,1,9,82,91,474,468,942
3290,37,3,0,0,52,37,89,83,81,164
3535,37,4,0,0,23,46,69,5,4,9
3821,37,8,0,1,9,140,149,1,15,16
3897,37,86,1,0,10,37,47,16,417,433
283,36,131,1,2,29,20,49,20,285,305
329,36,45,2,1,83,0,83,97,0,97
1718,36,7,0,1,18,89,107,325,335,660
1822,36,3,1,0,2,65,67,1,9,10
1848,36,36,0,0,66,110,176,376,473,849
2030,36,9,0,1,62,129,191,417,419,836
2218,36,21,0,0,53,0,53,23,0,23
2234,36,66,2,1,1,114,115,57,266,323
2475,36,17,0,0,35,92,127,8,23,31
2904,36,19,0,1,0,112,112,40,239,279
3037,36,15,0,1,158,0,158,39,0,39
3372,36,16,0,1,6,201,207,162,212,374
3530,36,6,0,2,32,28,60,5,5,10
3745,36,15,0,0,12,54,66,27,38,65
4012,36,4,0,1,110,256,366,9,11,20
4045,36,31,0,0,84,19,103,42,73,115
402,35,7,0,0,92,76,168,25,16,41
552,35,27,1,1,67,4,71,34,11,45
854,35,11,0,0,9,84,93,33,104,137
1158,35,39,1,2,52,0,52,70,0,70
1605,35,1,2,1,3,53,56,13,15,28
1631,35,9,0,0,170,84,254,50,41,91
1724,35,10,0,0,18,81,99,8,18,26
1730,35,24,0,0,85,17,102,60,71,131
1903,35,5,0,1,6,60,66,221,222,443
2266,35,21,0,0,8,34,42,325,359,684
2781,35,374,1,2,7,47,54,62,1616,1678
2915,35,12,0,1,77,15,92,153,133,286
2920,35,15,2,1,55,194,249,36,58,94
2990,35,3,0,1,30,14,44,38,39,77
3141,35,10,2,1,418,363,781,58,48,106
3307,35,20,1,1,354,206,560,998,958,1956
3406,35,85,2,1,64,96,160,30,405,435
3419,35,6,0,0,31,115,146,1,13,14
3862,35,19,0,1,81,61,142,86,82,168
48,34,3,0,1,0,67,67,18,19,37
228,34,9,0,1,113,54,167,61,52,113
571,34,1,0,1,0,56,56,11,12,23
706,34,6,0,0,12,51,63,604,624,1228
1923,34,18,0,1,3,87,90,286,319,605
2085,34,45,2,1,77,24,101,835,865,1700
2324,34,34,0,1,8,33,41,223,359,582
2526,34,15,0,0,74,262,336,80,128,208
2637,34,2,2,1,325,369,694,117,119,236
2750,34,22,0,0,38,0,38,38,0,38
2795,34,37,0,0,0,46,46,300,358,658
2962,34,4,0,1,59,0,59,4,0,4
3102,34,7,0,1,29,199,228,106,127,233
3208,34,17,1,1,71,65,136,20,188,208
3302,34,11,0,1,1,60,61,218,244,462
3369,34,4,0,0,42,435,477,5,0,5
3393,34,2,2,1,183,168,351,3,1,4
3568,34,10,0,0,62,49,111,117,121,238
3572,34,44,2,1,115,0,115,190,158,348
507,33,52,0,0,3,43,46,1275,1354,2629
600,33,12,0,1,16,132,148,26,11,37
1043,33,15,0,0,14,48,62,17,39,56
1225,33,57,2,1,49,3,52,226,69,295
1446,33,9,2,1,47,126,173,15,40,55
2197,33,52,0,1,2,262,264,17,135,152
2275,33,2,0,1,0,47,47,0,2,2
2303,33,20,0,1,15,56,71,22,62,84
2537,33,92,2,1,4,52,56,45,441,486
2636,33,8,0,1,13,69,82,161,173,334
3034,33,21,0,1,12,67,79,98,129,227
3069,33,4,0,1,87,51,138,7,1,8
3184,33,6,0,1,3,45,48,7,16,23
3338,33,29,0,0,16,64,80,53,77,130
3367,33,8,2,1,53,109,162,81,85,166
3398,33,18,0,1,24,281,305,132,168,300
3681,33,4,0,0,132,402,534,8,4,12
3695,33,101,0,1,45,19,64,156,945,1101
3717,33,15,0,0,17,114,131,103,146,249
3870,33,26,0,1,27,70,97,76,110,186
3993,33,4,0,1,64,44,108,52,52,104
4042,33,15,0,1,51,19,70,590,575,1165
323,32,4,0,2,31,53,84,4,0,4
733,32,14,0,0,20,31,51,32,37,69
896,32,19,0,1,39,39,78,220,216,436
958,32,13,0,0,77,6,83,153,145,298
1632,32,5,1,0,47,2,49,4,1,5
1983,32,2,2,1,1,211,212,44,46,90
2397,32,258,1,2,29,8,37,46,1523,1569
2568,32,2,0,0,8,55,63,101,95,196
2668,32,12,0,1,32,24,56,12,4,16
2725,32,117,2,1,7,41,48,13,327,340
2801,32,1,0,1,34,27,61,2,0,2
2991,32,15,0,1,147,186,333,25,60,85
3061,32,9,0,1,25,24,49,38,45,83
3179,32,8,0,0,10,55,65,61,72,133
3403,32,18,0,0,18,73,91,149,185,334
3554,32,20,1,2,55,36,91,30,51,81
3558,32,12,0,1,69,30,99,674,679,1353
3614,32,4,0,1,35,57,92,1027,1023,2050
4032,32,27,0,0,3,36,39,73,104,177
638,31,21,0,1,2,43,45,170,181,351
1188,31,10,1,0,33,0,33,10,0,10
1627,31,16,1,0,1,46,47,4,22,26
1768,31,149,2,1,81,11,92,287,907,1194
2087,31,31,2,1,88,319,407,33,0,33
2203,31,128,1,2,5,30,35,3,219,222
2508,31,2,0,1,59,2,61,4,0,4
2704,31,1,0,1,2,63,65,12,13,25
2751,31,4,2,1,6,83,89,0,4,4
2763,31,30,2,1,78,0,78,77,0,77
2907,31,2,0,1,27,18,45,9,9,18
2918,31,25,2,1,162,115,277,98,132,230
3748,31,73,1,0,46,0,46,145,0,145
3967,31,8,2,1,29,48,77,18,13,31
3991,31,2,0,0,28,133,161,25,24,49
300,30,11,2,1,123,0,123,23,0,23
1059,30,19,2,1,64,109,173,21,17,38
1752,30,2,0,0,11,29,40,2,4,6
1810,30,14,0,0,24,36,60,9,17,26
1956,30,20,0,1,28,58,86,174,224,398
2033,30,19,0,1,83,218,301,183,116,299
2204,30,28,0,1,229,537,766,300,334,634
2425,30,4,0,1,20,72,92,3,6,9
2478,30,29,2,1,948,920,1868,20,43,63
2569,30,1,0,1,3,178,181,0,1,1
3053,30,13,2,1,158,117,275,99,74,173
3420,30,122,2,1,5,43,48,116,673,789
3663,30,70,2,1,45,1,46,273,141,414
3876,30,17,2,1,461,409,870,41,20,61
3881,30,53,1,1,49,1,50,10,208,218
3909,30,9,0,1,38,126,164,150,188,338
3945,30,3,0,1,56,328,384,149,147,296
3955,30,28,2,1,77,65,142,158,313,471
43,29,30,0,0,24,16,40,425,402,827
1215,29,53,2,1,232,119,351,139,276,415
1412,29,6,0,1,1,84,85,2,11,13
1739,29,36,0,0,34,0,34,82,0,82
1771,29,436,1,0,24,7,31,72,1624,1696
1876,29,28,2,1,80,36,116,45,36,81
1911,29,16,0,1,4,115,119,2,27,29
1976,29,22,0,1,44,34,78,549,569,1118
2226,29,17,0,0,64,15,79,7,24,31
2428,29,2,0,1,17,159,176,29,28,57
2460,29,24,3,0,52,0,52,118,7,125
2965,29,1,0,1,30,25,55,2,0,2
3365,29,19,2,1,89,0,89,47,0,47
3392,29,10,0,0,39,60,99,5,19,24
3444,29,1,0,1,135,523,658,30,31,61
3551,29,16,2,1,5,73,78,8,26,34
3737,29,2,0,1,32,169,201,384,386,770
3912,29,49,1,0,39,0,39,107,0,107
4052,29,7,0,1,6,169,175,430,426,856
443,28,13,2,1,416,468,884,32,30,62
927,28,8,2,1,8,122,130,0,12,12
931,28,161,0,0,14,19,33,83,314,397
1330,28,94,0,0,28,47,75,206,385,591
1491,28,14,0,0,37,8,45,13,17,30
1742,28,27,2,1,73,10,83,575,538,1113
1944,28,9,0,1,91,39,130,32,39,71
2067,28,54,0,0,42,9,51,197,203,400
2131,28,9,0,1,21,46,67,480,493,973
2344,28,25,0,0,2,36,38,26,133,159
2563,28,16,2,1,34,43,77,86,98,184
2902,28,18,0,1,15,38,53,259,232,491
3236,28,29,0,0,30,126,156,103,101,204
3585,28,13,0,1,20,51,71,10,27,37
3781,28,1,0,0,108,29,137,43,42,85
3857,28,23,0,2,22,48,70,29,21,50
3943,28,16,0,0,140,28,168,149,150,299
827,27,1,0,0,0,41,41,20,21,41
1200,27,39,0,1,14,38,52,314,388,702
1257,27,8,0,1,2,36,38,198,214,412
1502,27,4,2,1,29,24,53,8,2,10
2072,27,16,0,0,15,41,56,353,449,802
2119,27,3,2,1,2,150,152,0,3,3
2362,27,3,0,0,57,8,65,3,1,4
2451,27,6,0,0,5,86,91,39,51,90
2468,27,41,2,1,49,0,49,84,0,84
2776,27,4,0,1,78,51,129,47,56,103
2876,27,20,0,1,80,122,202,120,151,271
3271,27,5,0,0,13,140,153,3,2,5
3318,27,25,0,0,53,0,53,48,0,48
3631,27,45,2,0,164,269,433,27,85,112
3694,27,16,0,1,10,87,97,90,131,221
3829,27,1,0,1,0,50,50,4,5,9
3891,27,1,0,1,4,43,47,172,173,345
3893,27,49,1,0,5,32,37,3,163,166
3905,27,75,0,1,5,33,38,160,395,555
3928,27,3,0,1,5,48,53,513,500,1013
3984,27,16,0,1,164,149,313,384,361,745
4015,27,7,0,1,3,77,80,14,21,35
4066,27,5,0,0,371,275,646,6,7,13
16,26,7,0,0,34,24,58,4,4,8
526,26,36,2,1,2453,977,3430,185,273,458
1103,26,5,0,1,0,54,54,337,340,677
2002,26,7,0,1,37,26,63,359,359,718
2106,26,2,0,0,33,39,72,62,64,126
2180,26,30,0,1,0,70,70,2,67,69
2216,26,6,0,1,54,0,54,6,0,6
2398,26,2,2,1,160,493,653,51,49,100
2484,26,27,0,1,4,35,39,68,130,198
2496,26,12,0,1,11,58,69,327,344,671
2548,26,53,0,1,75,2,77,413,274,687
2620,26,5,0,1,26,105,131,4,13,17
3138,26,12,0,0,10,20,30,8,21,29
3177,26,6,0,0,505,283,788,41,31,72
3343,26,3,1,0,12,58,70,0,3,3
3456,26,27,2,1,197,194,391,86,157,243
4022,26,34,0,0,99,0,99,77,0,77
4037,26,3,2,1,95,275,370,8,8,16
244,25,10,0,1,47,4,51,74,88,162
311,25,102,2,1,58,6,64,127,1063,1190
338,25,5,0,1,2,43,45,22,42,64
658,25,30,0,0,37,0,37,37,0,37
1084,25,19,0,0,75,0,75,71,0,71
1667,25,53,0,0,7,31,38,2,90,92
2166,25,1,0,1,26,57,83,3,0,3
2169,25,14,0,1,48,28,76,17,12,29
2188,25,14,0,1,22,22,44,552,580,1132
2206,25,6,0,0,1,42,43,12,25,37
2298,25,9,0,1,1202,1195,2397,98,88,186
2476,25,1,0,1,0,59,59,19,20,39
2594,25,9,0,0,49,54,103,14,22,36
2605,25,6,0,0,269,367,636,33,41,74
2756,25,32,0,1,345,343,688,111,173,284
2869,25,7,0,0,63,0,63,10,0,10
3329,25,3,0,1,71,0,71,3,0,3
3410,25,10,2,1,88,142,230,15,14,29
3595,25,34,0,1,31,11,42,33,53,86
3677,25,11,0,0,40,18,58,8,13,21
3771,25,9,0,1,24,5,29,121,125,246
3791,25,17,0,1,238,58,296,34,45,79
3889,25,23,0,0,53,0,53,47,0,47
306,24,4,0,1,60,127,187,671,691,1362
370,24,7,2,1,42,0,42,16,0,16
612,24,1,0,1,2,46,48,416,417,833
972,24,6,1,0,0,28,28,1,6,7
1149,24,72,1,0,27,0,27,168,0,168
1653,24,79,0,0,5,21,26,46,184,230
1802,24,3,0,0,6,33,39,8,9,17
2098,24,37,0,1,18,38,56,603,650,1253
2115,24,12,0,1,14,42,56,39,49,88
2126,24,62,2,1,111,5,116,308,203,511
2374,24,11,0,1,33,23,56,531,498,1029
2897,24,10,0,0,489,52,541,56,55,111
3017,24,23,0,1,44,52,96,346,388,734
3389,24,5,0,0,15,84,99,116,122,238
3710,24,4,0,0,11,44,55,9,12,21
3713,24,2,0,1,11,56,67,118,119,237
3777,24,7,0,1,6,47,53,2,16,18
3806,24,31,0,0,15,24,39,630,696,1326
846,23,8,1,2,38,0,38,12,0,12
864,23,10,0,1,30,0,30,14,0,14
1272,23,17,0,1,24,19,43,418,432,850
1305,23,1,0,1,1,54,55,33,35,68
1518,23,5,0,1,3,28,31,283,284,567
1576,23,5,0,0,22,19,41,1,4,5
2120,23,14,0,0,9,34,43,36,42,78
2494,23,1,0,1,54,4,58,184,183,367
2528,23,41,2,1,0,38,38,11,349,360
2545,23,93,0,0,42,0,42,176,0,176
2833,23,21,0,0,112,0,112,67,0,67
3495,23,3,0,1,11,69,80,48,51,99
3678,23,13,0,0,46,15,61,57,22,79
3974,23,10,0,0,56,52,108,19,23,42
591,22,4,0,0,5,27,32,2,13,15
675,22,11,0,1,33,36,69,87,88,175
717,22,38,0,0,28,13,41,181,220,401
779,22,137,1,0,0,23,23,56,384,440
1010,22,2,0,1,7,42,49,0,2,2
1338,22,3,0,1,13,21,34,1,4,5
1616,22,3,0,1,3,33,36,115,110,225
1893,22,10,0,1,31,30,61,477,448,925
2251,22,8,0,0,36,12,48,41,44,85
2382,22,12,0,0,1,23,24,52,79,131
2834,22,3,0,0,25,67,92,13,17,30
2877,22,16,1,1,795,800,1595,7,14,21
2928,22,3,0,1,148,161,309,461,465,926
2949,22,34,0,1,114,70,184,521,552,1073
3094,22,47,0,1,36,60,96,227,396,623
3545,22,5,0,0,44,0,44,5,0,5
3553,22,5,2,1,45,80,125,3,9,12
3601,22,8,0,0,20,19,39,5,10,15
3609,22,3,0,1,32,0,32,4,0,4
3911,22,32,2,1,141,165,306,81,132,213
3952,22,7,0,1,17,7,24,53,47,100
1066,21,6,2,1,93,0,93,10,0,10
1280,21,5,0,1,11,25,36,179,186,365
1421,21,5,0,1,12,29,41,14,9,23
1535,21,30,2,1,55,0,55,60,0,60
1782,21,10,0,0,21,0,21,24,0,24
1927,21,144,2,1,28,12,40,135,466,601
2088,21,54,1,0,23,0,23,109,0,109
2336,21,50,2,0,40,89,129,74,4,78
2371,21,29,0,0,29,0,29,206,215,421
2500,21,80,2,1,11,83,94,28,438,466
2706,21,9,0,0,50,91,141,58,62,120
2872,21,42,0,0,41,19,60,197,81,278
2914,21,75,0,1,8,21,29,279,142,421
2983,21,5,0,1,25,0,25,5,3,8
3107,21,18,0,1,8,24,32,455,508,963
3278,21,14,0,1,5,42,47,5,38,43
3427,21,4,0,0,90,21,111,6,0,6
3484,21,19,0,0,8,21,29,42,57,99
3500,21,49,0,1,2,50,52,66,1001,1067
3788,21,2,0,0,64,96,160,3,2,5
3872,21,8,0,1,28,64,92,135,153,288
3886,21,29,2,1,21,10,31,78,10,88
3999,21,3,0,1,20,60,80,2,3,5
274,20,28,0,0,0,25,25,4,52,56
379,20,4,0,0,40,0,40,6,0,6
587,20,9,0,0,30,0,30,13,0,13
598,20,16,0,1,28,43,71,703,682,1385
926,20,35,2,1,48,0,48,53,0,53
981,20,1,0,1,21,0,21,1,0,1
1912,20,7,0,0,76,0,76,12,0,12
2523,20,60,0,0,1,29,30,18,213,231
3066,20,2,0,1,5,46,51,195,197,392
3195,20,2,0,1,23,9,32,41,39,80
3211,20,167,2,1,18,19,37,194,598,792
3222,20,4,0,1,52,0,52,5,0,5
3534,20,8,2,1,55,45,100,22,28,50
3724,20,4,0,1,17,15,32,14,7,21
3902,20,5,0,1,53,0,53,186,0,186
3965,20,11,0,0,66,77,143,110,118,228
4003,20,11,0,1,51,16,67,151,149,300
982,19,2,0,1,3,29,32,134,134,268
1073,19,14,2,1,510,1918,2428,30,38,68
1143,19,126,2,1,27,1,28,203,645,848
1637,19,102,2,0,29,5,34,312,133,445
2140,19,84,0,2,3,38,41,0,290,290
2150,19,96,2,1,0,74,74,11,766,777
2255,19,7,0,1,35,20,55,334,323,657
2329,19,25,0,1,16,14,30,341,356,697
2433,19,3,0,1,9,39,48,6,7,13
2499,19,2,2,1,4,146,150,506,508,1014
2544,19,6,0,0,1,19,20,115,124,239
2720,19,4,0,1,13,23,36,7,3,10
2807,19,2,0,0,10,91,101,425,428,853
2812,19,2,0,0,386,440,826,57,46,103
2818,19,3,0,0,314,369,683,21,17,38
2849,19,10,2,1,511,8,519,919,900,1819
2952,19,8,0,1,17,11,28,285,269,554
3180,19,4,2,1,120,0,120,4,0,4
3216,19,40,0,1,0,20,20,109,183,292
3310,19,3,0,1,19,12,31,85,84,169
3440,19,9,0,1,0,20,20,12,21,33
3763,19,4,2,1,29,51,80,8,3,11
4033,19,2,0,1,3,45,48,4,8,12
4046,19,6,0,1,29,0,29,7,0,7
517,18,9,0,1,21,35,56,15,25,40
1209,18,25,2,1,1,94,95,6,68,74
1235,18,16,0,0,8,14,22,16,46,62
1273,18,2,0,1,11,26,37,4,2,6
1871,18,52,0,0,1,22,23,68,180,248
2101,18,24,0,0,36,25,61,202,239,441
2175,18,94,0,1,3,30,33,88,506,594
2345,18,10,0,0,39,20,59,54,29,83
2358,18,5,0,0,155,0,155,6,0,6
2481,18,1,0,1,49,34,83,3,1,4
2951,18,1,0,1,4,30,34,77,78,155
3168,18,7,0,1,14,40,54,160,156,316
3229,18,5,2,1,30,87,117,3,2,5
3279,18,3,0,1,49,14,63,103,100,203
3363,18,7,0,0,22,26,48,41,52,93
3539,18,13,2,1,12,56,68,17,32,49
4030,18,13,0,1,22,31,53,160,145,305
156,17,188,2,1,12,21,33,90,1237,1327
901,17,1,0,1,4,13,17,65,66,131
1409,17,370,1,0,14,4,18,37,1690,1727
2151,17,15,0,0,76,65,141,106,124,230
2744,17,6,2,1,25,49,74,4,2,6
2948,17,42,2,1,30,13,43,16,370,386
2963,17,3,0,0,80,140,220,6,9,15
3048,17,11,0,1,22,17,39,422,388,810
3139,17,7,0,0,34,25,59,8,7,15
3199,17,1,0,1,17,17,34,5,6,11
3253,17,20,2,1,14,57,71,29,3,32
3906,17,369,1,0,27,0,27,52,1295,1347
3919,17,1,0,1,180,161,341,88,89,177
3920,17,11,0,2,5,22,27,18,62,80
3983,17,35,0,0,10,15,25,132,204,336
4001,17,2,0,0,34,14,48,2,2,4
4017,17,8,2,1,75,61,136,82,75,157
448,16,5,0,1,87,71,158,84,79,163
1166,16,2,0,1,5,31,36,62,61,123
1542,16,41,0,1,3,16,19,2,51,53
2171,16,10,0,0,22,0,22,27,0,27
2405,16,3,0,0,51,0,51,3,0,3
2910,16,6,2,1,2,49,51,21,8,29
3166,16,5,2,1,20,0,20,9,0,9
3225,16,1,0,1,29,40,69,2,1,3
3542,16,2,0,0,4,14,18,5,4,9
3588,16,45,2,1,0,48,48,10,281,291
3794,16,13,0,0,8,44,52,44,59,103
4008,16,2,0,1,1,24,25,430,433,863
286,15,332,1,0,11,5,16,73,1547,1620
299,15,4,0,0,3,30,33,10,15,25
766,15,8,0,0,5,12,17,36,54,90
1226,15,19,0,0,12,20,32,26,9,35
1532,15,17,0,1,8,22,30,216,234,450
1635,15,3,2,1,25,0,25,3,0,3
1668,15,25,1,2,1,21,22,0,31,31
1941,15,4,0,1,20,4,24,3,7,10
2068,15,5,0,1,36,39,75,489,499,988
2081,15,19,0,1,26,28,54,139,168,307
2320,15,1,0,0,25,0,25,1,0,1
2335,15,2,0,1,11,26,37,389,391,780
2455,15,10,2,2,5,21,26,20,25,45
2480,15,8,0,1,40,35,75,439,446,885
2816,15,3,0,1,9,14,23,4,7,11
3075,15,6,0,1,1,22,23,2,8,10
3163,15,8,0,1,42,22,64,121,93,214
3207,15,8,0,1,10,29,39,3,10,13
3331,15,3,0,1,9,57,66,6,3,9
3332,15,7,0,1,9,15,24,502,498,1000
3346,15,6,0,1,0,109,109,8,23,31
3511,15,1,0,0,0,25,25,0,1,1
3756,15,8,1,0,8,12,20,19,38,57
3838,15,6,0,0,27,46,73,6,8,14
3927,15,2,0,1,16,20,36,9,9,18
804,14,12,0,1,3,21,24,193,216,409
1381,14,10,0,1,23,4,27,356,379,735
1797,14,6,0,0,5,18,23,253,251,504
1815,14,13,2,1,0,31,31,61,1,62
1857,14,1,0,1,17,39,56,368,377,745
1994,14,1,0,0,18,6,24,1,0,1
2514,14,2,0,0,70,24,94,124,123,247
2531,14,9,0,0,1,14,15,6,16,22
2858,14,56,2,1,36,9,45,13,191,204
2899,14,32,2,1,9,27,36,105,426,531
3115,14,72,0,1,16,0,16,168,17,185
3209,14,1,0,1,171,629,800,44,47,91
3266,14,8,1,1,15,0,15,13,0,13
3443,14,3,0,0,3,31,34,3,9,12
3552,14,3,0,1,2,28,30,8,21,29
3775,14,37,1,0,6,13,19,9,86,95
3790,14,1,0,0,9,9,18,15,13,28
3836,14,174,0,0,1,15,16,117,653,770
3929,14,7,0,1,4,46,50,210,202,412
961,13,4,0,0,19,0,19,4,0,4
1438,13,2,0,1,9,17,26,210,214,424
1971,13,2,0,1,1,18,19,300,303,603
2143,13,28,0,1,288,304,592,338,361,699
2179,13,12,0,1,180,182,362,66,58,124
2263,13,6,0,1,6,20,26,67,62,129
2488,13,7,0,0,2,19,21,20,25,45
2562,13,7,2,1,19,3,22,19,19,38
2604,13,4,0,0,156,630,786,7,14,21
3431,13,1,0,0,5,38,43,3,4,7
3446,13,6,0,0,2,13,15,10,16,26
3618,13,3,0,0,4,21,25,13,12,25
3679,13,245,1,2,15,0,15,10,497,507
4002,13,289,2,1,15,6,21,65,921,986
33,12,7,1,1,2,12,14,10,21,31
481,12,45,0,2,6,6,12,4,59,63
629,12,1,0,1,1,33,34,5,6,11
677,12,4,0,1,29,78,107,146,336,482
1685,12,39,0,0,19,0,19,59,3,62
1746,12,172,1,0,11,1,12,19,510,529
1897,12,2,0,1,6,7,13,1,4,5
2737,12,9,2,1,39,1,40,65,76,141
2811,12,5,0,0,47,48,95,119,123,242
2905,12,2,0,1,0,16,16,22,26,48
2992,12,2,0,0,3,12,15,8,11,19
3032,12,12,0,0,11,12,23,57,68,125
3155,12,1,2,1,11,35,46,24,25,49
3157,12,32,1,1,5,15,20,6,49,55
3339,12,1,0,1,0,13,13,10,11,21
3396,12,3,0,1,27,6,33,3,2,5
3608,12,1,0,0,11,65,76,3,2,5
3877,12,4,0,1,12,24,36,282,286,568
3968,12,22,0,1,0,45,45,42,133,175
4024,12,4,0,1,10,63,73,132,136,268
100,11,13,2,1,0,11,11,7,29,36
407,11,4,0,1,6,5,11,220,226,446
868,11,8,4,1,13,8,21,101,95,196
1040,11,39,1,1,2,10,12,9,102,111
1255,11,19,0,0,10,7,17,21,56,77
1373,11,121,1,0,12,2,14,92,336,428
1461,11,2,0,0,12,11,23,45,46,91
1529,11,4,0,1,1,10,11,21,27,48
1839,11,14,2,1,32,0,32,16,39,55
2080,11,6,0,0,20,0,20,9,0,9
2661,11,9,0,0,8,21,29,3,15,18
2779,11,13,0,1,50,0,50,46,0,46
2854,11,5,0,0,14,0,14,5,0,5
3201,11,21,1,0,1,10,11,79,10,89
3374,11,16,0,1,13,17,30,293,272,565
3447,11,143,1,1,27,10,37,58,944,1002
3739,11,283,1,2,11,1,12,32,672,704
1088,10,5,0,0,4,7,11,0,17,17
1675,10,9,0,1,29,1,30,425,420,845
1895,10,23,1,0,10,0,10,25,0,25
2177,10,189,2,1,17,9,26,87,1084,1171
2182,10,1,0,1,0,16,16,3,4,7
2213,10,6,0,0,2,11,13,0,8,8
2246,10,14,2,0,1,13,14,10,36,46
2454,10,14,0,1,7,13,20,93,84,177
2752,10,59,0,1,15,0,15,151,301,452
2817,10,4,0,0,0,11,11,8,11,19
3260,10,6,0,1,9,7,16,643,648,1291
3536,10,14,0,1,10,8,18,25,3,28
3645,10,1,0,1,2,29,31,9,8,17
3753,10,4,0,1,9,5,14,85,23,108
3834,10,2,0,2,9,13,22,30,28,58
261,9,4,0,2,4,24,28,0,4,4
767,9,19,0,0,17,0,17,44,0,44
971,9,2,0,1,71,14,85,377,377,754
1493,9,11,0,0,6,3,9,12,18,30
1503,9,2,0,1,9,0,9,2,0,2
1510,9,176,2,1,26,2,28,56,1069,1125
1636,9,5,0,1,13,11,24,320,319,639
1950,9,15,2,1,47,45,92,303,288,591
2176,9,1,0,0,6,12,18,21,23,44
2212,9,12,2,1,1,13,14,3,23,26
2254,9,8,0,1,7,10,17,154,163,317
2267,9,4,0,1,9,0,9,127,130,257
2384,9,8,0,1,0,12,12,166,34,200
2529,9,13,0,1,48,58,106,60,81,141
2681,9,1,2,1,0,11,11,29,30,59
2722,9,8,1,1,13,4,17,12,0,12
2739,9,234,2,1,6,6,12,77,1458,1535
2764,9,41,2,1,17,31,48,23,132,155
2947,9,11,2,1,1,26,27,16,31,47
3109,9,11,0,0,19,0,19,310,340,650
3261,9,6,0,0,28,0,28,50,0,50
3375,9,4,0,0,10,17,27,12,18,30
3462,9,2,0,0,13,5,18,2,1,3
3933,9,2,0,1,11,22,33,28,26,54
4020,9,3,0,0,11,0,11,3,0,3
362,8,14,0,0,1,13,14,0,17,17
538,8,12,0,0,10,0,10,25,0,25
910,8,10,0,1,42,43,85,775,784,1559
976,8,2,0,0,13,0,13,2,0,2
990,8,6,0,1,1,8,9,4,12,16
1496,8,52,1,1,2,8,10,12,146,158
1568,8,24,0,0,3,6,9,14,58,72
1860,8,4,0,1,14,19,33,471,473,944
1945,8,1,0,0,18,4,22,2,1,3
2073,8,2,0,1,0,8,8,22,24,46
2099,8,1,0,1,14,14,28,687,688,1375
2157,8,11,0,1,20,17,37,71,92,163
2243,8,71,1,2,1,9,10,5,138,143
2258,8,4,0,1,0,9,9,15,19,34
2672,8,4,0,0,16,13,29,0,8,8
2959,8,3,0,0,1,13,14,5,8,13
3005,8,62,0,1,17,10,27,159,56,215
3262,8,3,0,0,3,12,15,4,7,11
3480,8,6,0,1,1,9,10,30,37,67
3736,8,20,1,1,18,0,18,20,58,78
3964,8,5,0,0,18,2,20,174,175,349
4010,8,5,0,1,19,13,32,107,106,213
4018,8,3,2,1,164,0,164,4,0,4
4061,8,4,2,1,3,18,21,5,9,14
4065,8,33,0,1,0,9,9,10,473,483
556,7,52,2,1,0,13,13,67,223,290
648,7,23,2,1,1,9,10,8,69,77
709,7,1,0,1,2,16,18,26,25,51
738,7,19,0,0,8,4,12,159,119,278
1601,7,8,1,2,10,0,10,9,16,25
1804,7,3,0,0,2,6,8,1,4,5
2008,7,15,0,1,10,10,20,364,373,737
2113,7,1,0,0,20,10,30,1,2,3
2147,7,360,0,0,2,6,8,37,1130,1167
2240,7,18,0,0,6,4,10,65,24,89
2386,7,6,0,0,11,20,31,9,28,37
2432,7,13,2,1,10,13,23,18,39,57
2728,7,22,2,1,11,34,45,127,180,307
2871,7,2,0,1,13,0,13,7,0,7
2971,7,85,2,1,7,13,20,76,472,548
3853,7,13,2,1,8,0,8,21,0,21
3901,7,8,0,1,520,502,1022,179,197,376
3925,7,394,1,2,6,1,7,37,2190,2227
3947,7,3,2,1,51,57,108,104,111,215
453,6,1,0,1,3,17,20,148,149,297
659,6,5,0,1,9,8,17,211,224,435
1156,6,7,2,1,12,0,12,11,0,11
1234,6,3,1,0,7,0,7,4,0,4
1380,6,2,1,1,7,0,7,8,0,8
1611,6,7,1,0,6,0,6,10,0,10
1716,6,44,1,2,14,0,14,50,0,50
1827,6,7,0,0,7,0,7,12,0,12
2184,6,2,0,0,12,1,13,16,19,35
2466,6,3,0,0,3,3,6,2,3,5
2707,6,6,0,1,3,7,10,170,176,346
2766,6,7,2,1,0,11,11,0,9,9
2844,6,1,0,1,0,11,11,0,1,1
2988,6,3,0,0,15,1,16,6,6,12
3193,6,2,0,1,12,7,19,9,10,19
3231,6,1,0,1,0,8,8,63,64,127
3474,6,53,2,1,91,91,182,642,779,1421
3634,6,10,2,1,7,0,7,21,0,21
3637,6,4,0,1,3,5,8,4,7,11
3786,6,1,0,0,8,0,8,1,0,1
3802,6,20,1,1,10,0,10,59,0,59
1120,5,1,0,0,3,4,7,209,212,421
1258,5,2,0,1,3,9,12,110,115,225
1499,5,1,0,1,7,15,22,4,5,9
2193,5,2,0,1,6,0,6,5,0,5
2272,5,8,2,1,5,0,5,8,0,8
2339,5,5,0,1,11,0,11,14,0,14
2911,5,5,0,1,11,0,11,11,0,11
3057,5,191,2,1,2,3,5,224,657,881
3300,5,2,0,0,3,6,9,6,12,18
3320,5,1,0,2,5,0,5,1,0,1
3752,5,6,0,1,5,23,28,399,409,808
3931,5,1,0,0,0,5,5,2,3,5
3942,5,4,0,1,6,13,19,73,69,142
3987,5,34,2,1,11,0,11,257,0,257
594,4,8,2,1,7,3,10,40,38,78
673,4,1,0,0,4,0,4,1,0,1
917,4,1,0,1,2,4,6,25,26,51
930,4,4,0,1,51,58,109,287,295,582
1243,4,4,0,1,52,53,105,22,18,40
1356,4,4,1,0,4,0,4,4,0,4
1726,4,45,2,1,0,7,7,107,210,317
2222,4,1,0,1,8,3,11,396,395,791
2268,4,14,1,1,2,2,4,20,0,20
2309,4,5,0,1,7,0,7,1231,1242,2473
2630,4,2,0,0,1,4,5,4,2,6
2715,4,2,0,1,3,4,7,13,12,25
2829,4,12,0,1,1,8,9,147,175,322
2966,4,8,2,1,4,0,4,85,87,172
2998,4,3,0,1,4,0,4,4,0,4
3119,4,1,0,1,8,0,8,52,51,103
3133,4,5,0,0,2,7,9,275,284,559
3548,4,31,2,1,1,3,4,22,117,139
3664,4,1,0,1,0,5,5,4,5,9
3960,4,2,1,2,9,4,13,8,6,14
4025,4,1,1,2,3,5,8,8,9,17
4054,4,4,0,1,20,22,42,235,228,463
425,3,1,0,1,2,3,5,1,0,1
608,3,7,0,1,0,4,4,16,28,44
700,3,24,2,1,6,0,6,17,69,86
974,3,1,0,1,4,2,6,85,86,171
1263,3,5,0,1,2,4,6,78,79,157
1408,3,13,1,1,2,1,3,1,18,19
1520,3,3,0,1,4,0,4,3,0,3
1544,3,1,0,1,29,26,55,936,937,1873
1966,3,11,0,0,5,3,8,114,120,234
2402,3,1,0,1,55,5,60,5,4,9
2412,3,3,0,0,4,0,4,4,0,4
2524,3,6,2,1,3,2,5,143,142,285
2702,3,1,0,0,5,0,5,18,19,37
2735,3,4,1,0,3,0,3,4,0,4
3033,3,2,0,1,0,5,5,15,15,30
3047,3,12,1,0,3,0,3,12,0,12
3090,3,1,0,0,0,3,3,0,1,1
3570,3,9,1,1,10,0,10,35,6,41
3589,3,21,2,1,13,0,13,19,82,101
3592,3,1,2,1,5,0,5,1,0,1
3622,3,1,0,1,0,3,3,0,1,1
3760,3,8,0,1,3,0,3,9,0,9
3864,3,2,0,1,0,3,3,40,41,81
456,2,6,0,0,0,2,2,3,9,12
894,2,2,0,1,0,2,2,1,3,4
985,2,1,0,1,1,1,2,1234,1233,2467
1401,2,3,1,0,2,0,2,6,0,6
1420,2,7,1,2,3,3,6,4,3,7
1607,2,7,1,2,4,2,6,11,21,32
1710,2,3,0,1,5,7,12,79,83,162
2130,2,9,1,1,6,4,10,87,177,264
2186,2,2,2,1,2,4,6,20,15,35
2208,2,4,0,1,8,5,13,219,251,470
2588,2,18,0,0,0,2,2,7,30,37
2847,2,25,0,0,0,2,2,4,50,54
2894,2,1,2,2,1,2,3,3,4,7
2895,2,1,0,1,1,3,4,22,23,45
3333,2,5,2,1,3,0,3,5,0,5
3476,2,26,3,0,0,8,8,8,104,112
3555,2,6,0,1,0,3,3,91,97,188
3581,2,3,0,1,1,1,2,19,24,43
3839,2,2,0,1,147,149,296,85,85,170
3923,2,4,2,1,3,3,6,6,1,7
4026,2,1,0,0,4,4,8,4,3,7
4036,2,42,1,1,1346,1347,2693,26,325,351
4049,2,4,1,0,2,0,2,4,0,4
590,1,1,0,0,2,0,2,1,0,1
699,1,1,2,1,1,0,1,2,0,2
986,1,1,0,1,40,74,114,5,6,11
1251,1,5,0,1,23,20,43,222,224,446
1293,1,1,0,1,1,0,1,3,4,7
1830,1,45,2,1,3,4,7,123,340,463
1846,1,8,1,0,1,0,1,1,51,52
1962,1,139,0,0,1,0,1,23,425,448
1997,1,1,0,1,9,0,9,7,0,7
2207,1,1,0,1,1,0,1,1,0,1
2334,1,1,0,1,1,0,1,1,0,1
2348,1,3,0,1,6,20,26,55,56,111
2443,1,276,2,1,0,1,1,106,1164,1270
2456,1,5,0,3,71,72,143,170,181,351
2536,1,4,2,1,0,1,1,8,18,26
2927,1,2,0,1,1,0,1,5,5,10
3019,1,4,0,1,1,0,1,1,5,6
3058,1,117,2,0,2,0,2,54,923,977
3167,1,5,0,3,44,45,89,107,96,203
3371,1,2,0,0,0,1,1,9,26,35
3387,1,1,2,1,1,0,1,13,0,13
3566,1,5,2,1,3,2,5,1,4,5
3888,1,1,0,0,4,5,9,28,29,57
3932,1,1,0,1,5,6,11,253,254,507
4047,1,2,2,1,3,3,6,11,6,17
4058,1,1,0,1,0,1,1,2,3,5
